Name	Sequence	ets1_pos	ets1_start	runx1_pos	runx1_start	distance	ori	label
seq1001_all_clean_seqs_gap0_no20_0.4	CCGGTCCGCTCGCCGGAAATGCGGGCTCTCCTGCCG	15	14	22	20	7	er	independent
seq1002_all_clean_seqs_gap0_no20_0.4	GGGGCAGCTTCCGGCAGGAGAGCCCGCATTCACGGC	10	8	24	22	14	er	independent
seq1003_all_clean_seqs_gap0_no20_0.4	GGCTGGGGCGGTATCCTGTGGTCTTACTCTGGTGAC	14	12	19	17	5	er	independent
seq1004_all_clean_seqs_gap0_no20_0.4	CCGCCCTAGAGCAGGAAATAGCGGTCAGCGCCAGCT	14	13	22	20	8	er	cooperative
seq1005_all_clean_seqs_gap0_no20_0.4	CTGCGTTTCCTCTGAGTTTTGCATGTTGAGGTTGGA	8	6	29	27	21	er	independent
seq1006_all_clean_seqs_gap0_no20_0.4	AGCCTCTTCCTGCTCCTGATCAGCGGTTATCTTGCT	8	6	24	22	16	er	independent
seq1008_all_clean_seqs_gap0_no20_0.4	CCGGGCTGCGGAAGGCGGGAATTCTGCGGTTCGCGG	10	9	27	25	17	er	cooperative
seq1298_all_clean_seqs_gap0_no20_0.4	CCGGGCTGCGGAAGGCGGGAATTCTGCGGTTCGCGG	10	9	27	25	17	er	cooperative
seq1009_all_clean_seqs_gap0_no20_0.4	GCTGCAGCAGGCGGGAAGTCTGCGGTTCGCGGGCTC	14	13	23	21	9	er	cooperative
seq1299_all_clean_seqs_gap0_no20_0.4	GCTGCAGCAGGCGGGAAGTCTGCGGTTCGCGGGCTC	14	13	23	21	9	er	cooperative
seq1010_all_clean_seqs_gap0_no20_0.4	CCACTGCTTCCGCCTTCTCTGCTGGCTGCGGGGAGC	9	7	29	27	20	er	independent
seq1012_all_clean_seqs_gap0_no20_0.4	GTGTTCAGACGGAAGCGTTATTCAGTGGTCAGAGCA	11	10	26	24	15	er	independent
seq1014_all_clean_seqs_gap0_no20_0.4	TCCAGGATGTGCTGAACCTCCAGAAACCACCGGCTT	5	4	27	25	22	er	cooperative
seq1017_all_clean_seqs_gap0_no20_0.4	AATCCACCGGAAACACTTAGACGCCGCAACCCCAGT	9	8	24	22	15	er	independent
seq1018_all_clean_seqs_gap0_no20_0.4	CTGCACAGGGAAGTGAGTGTCGAGCTCACCGCACCG	9	8	29	27	20	er	cooperative
seq1019_all_clean_seqs_gap0_no20_0.4	TGCTGCAGCGGCGCTTCCTGGTGGTCAGGGCGCCAT	16	14	22	20	6	er	independent
seq101_all_clean_seqs_gap0_no20_0.4	AGTCTCGTTTCCTGTGCGCTGTGGCCACCTGGCAGC	10	8	22	20	12	er	independent
seq1020_all_clean_seqs_gap0_no20_0.4	CAGCCGACTTCCGGGGTGGGGCTTGCTGCCGCAGAG	10	8	29	27	19	er	independent
seq1021_all_clean_seqs_gap0_no20_0.4	CTTCAGGGGTGGGGCTTCCTGCCGCAGAGCCGCCTT	17	15	22	20	5	er	independent
seq1022_all_clean_seqs_gap0_no20_0.4	GGGAGGGCGGAAGGCGGCTCTGCGGCAGCAAGCCCC	9	8	23	21	14	er	ambiguous
seq1024_all_clean_seqs_gap0_no20_0.4	CATTCCCGAGAGACTTCCGCGCCGCAGTTTCCCTGC	16	14	22	20	6	er	independent
seq1026_all_clean_seqs_gap0_no20_0.4	TTGCACACGTGGGCGGGAAGTGGTTAAGCGGCCTCA	16	15	21	19	5	er	cooperative
seq102_all_clean_seqs_gap0_no20_0.4	CCCTCTGAGACAGGATTTGCTTCCCACACAAGGCTA	13	12	24	22	11	er	independent
seq326_all_clean_seqs_gap0_no20_0.4	CCCTCTGAGACAGGATTTGCTTCCCACACAAGGCTA	13	12	24	22	11	er	independent
seq1030_all_clean_seqs_gap0_no20_0.4	GCAGAAACAGGAAGAGACAGGGCTGACCGCAGCAGG	10	9	27	25	17	er	cooperative
seq1031_all_clean_seqs_gap0_no20_0.4	GGCAGGAAGGAATGGCGGGAACGGGGCCCGCAGGGC	5	4	28	26	23	er	independent
seq1032_all_clean_seqs_gap0_no20_0.4	CAGAGAAACAGGAAGAACAGTGGTTTCAACTGAAAT	11	10	21	19	10	er	independent
seq1033_all_clean_seqs_gap0_no20_0.4	TATGACCAGGGGAGGGAAGTGACCACAGCATATCAC	15	14	23	21	8	er	independent
seq1034_all_clean_seqs_gap0_no20_0.4	ACAGATAGTGATATCCTGTGGTCAATTCCCTCCCCT	14	12	19	17	5	er	ambiguous
seq1035_all_clean_seqs_gap0_no20_0.4	GCCGTCACTTCCGTCATTCAAACCGCCCGCCAATGG	10	8	23	21	13	er	cooperative
seq1036_all_clean_seqs_gap0_no20_0.4	CGAGATCCTGGCCACGGATGCGGTGGCCGCGCCTCT	16	15	21	19	5	er	cooperative
seq1037_all_clean_seqs_gap0_no20_0.4	GACAGGATACAAGAATTCCGCGGACTGCCGCAGTCG	5	4	28	26	23	er	independent
seq1038_all_clean_seqs_gap0_no20_0.4	CCTCTCCATCTTCCGCACCACTGAGGCCGCAGTCTC	12	10	27	25	15	er	ambiguous
seq1039_all_clean_seqs_gap0_no20_0.4	GTCCCCTGAATTTTCCTGTGGTTCTTATCACCAGGT	14	12	19	17	5	er	independent
seq1041_all_clean_seqs_gap0_no20_0.4	GAGGCAGGCGGATGTCAGTGTGGTTAGAGCACAGTG	10	9	21	19	11	er	cooperative
seq1042_all_clean_seqs_gap0_no20_0.4	AGGCTTCCGGCCACGCCCCCTTCCCGCGGTTGCTAG	6	4	27	25	21	er	cooperative
seq1043_all_clean_seqs_gap0_no20_0.4	CAGGGAAGTTCGAACTGGGCGGGGCCCACCGCAGTT	4	3	29	27	25	er	independent
seq1044_all_clean_seqs_gap0_no20_0.4	TTACTGCCGGAACTTGGGACCTTTGTAACCACGTCT	9	8	29	27	20	er	independent
seq1045_all_clean_seqs_gap0_no20_0.4	GGCGGCCTCAACTTCCGCGGTGGGACTCCGGAGCAG	14	12	18	16	4	er	independent
seq1046_all_clean_seqs_gap0_no20_0.4	CTAACCCTTCTCTTCCTGCAAAAACCACAACAAAGG	14	12	25	23	11	er	cooperative
seq1302_all_clean_seqs_gap0_no20_0.4	CTAACCCTTCTCTTCCTGCAAAAACCACAACAAAGG	14	12	25	23	11	er	cooperative
seq1048_all_clean_seqs_gap0_no20_0.4	TTGACCCGGACGTGGACAAAAGACCGCAAAGGACGC	8	7	24	22	16	er	cooperative
seq1050_all_clean_seqs_gap0_no20_0.4	TTGTGCTTCCTGCTCATGAGATTGCTAGCGGTTACT	8	6	29	27	21	er	cooperative
seq1303_all_clean_seqs_gap0_no20_0.4	TTGTGCTTCCTGCTCATGAGATTGCTAGCGGTTACT	8	6	29	27	21	er	independent
seq1051_all_clean_seqs_gap0_no20_0.4	AGCGCCACACTTCCGCTTTGCGGCAGTGTGCGCCCC	12	10	21	19	9	er	independent
seq1053_all_clean_seqs_gap0_no20_0.4	GCACAGGAAAAGCTGCTTTCCGCGTGGTAAATTCAA	6	5	25	23	19	er	independent
seq1055_all_clean_seqs_gap0_no20_0.4	ACGCCGCGCATCCGCGCTTTACGGCGGCCGCAAAAT	11	9	28	26	17	er	independent
seq1056_all_clean_seqs_gap0_no20_0.4	TCTCCCGGAACTGCTCCTTCACCATGATGACCGCTG	7	6	31	29	24	er	independent
seq1057_all_clean_seqs_gap0_no20_0.4	CTGTCATCTTCCTGACAGCACGCCCACAAAGGACCA	10	8	24	22	14	er	independent
seq1058_all_clean_seqs_gap0_no20_0.4	CTAGCTGTCCCACAGGGAAGTGGTCAGGAGGCAGTT	16	15	21	19	5	er	cooperative
seq1059_all_clean_seqs_gap0_no20_0.4	ACGCGCTCCCTCACTTCCTGCGGCTTTTGGTCCCTC	16	14	21	19	5	er	independent
seq1060_all_clean_seqs_gap0_no20_0.4	TGGCGGGAGAACTTCCCCCTGTGCGGTCGCGACGTG	14	12	24	22	10	er	independent
seq1061_all_clean_seqs_gap0_no20_0.4	ATCTTAAGTGTTTCCTGACACCACAAATCCCCAAAC	13	11	21	19	8	er	independent
seq1062_all_clean_seqs_gap0_no20_0.4	TCCCGAGAGTGCGGCGGAAACCACGCGGCGCCGCCG	16	15	21	19	5	er	independent
seq1063_all_clean_seqs_gap0_no20_0.4	AACTAGAGCGTCATTTCCTGTGGGTACAAGTCCAGT	16	14	21	19	5	er	independent
seq1065_all_clean_seqs_gap0_no20_0.4	GCTGATAAAACAGGATGTGGTAAAGAAGCCGGCCAA	13	12	18	16	5	er	cooperative
seq1069_all_clean_seqs_gap0_no20_0.4	TGATAAAACACAGGATGTGGTAAGGGAGCTGGCCAA	13	12	18	16	5	er	cooperative
seq106_all_clean_seqs_gap0_no20_0.4	CAGAGAGAGGCCACATCCCTGTGGTCACACATACCC	16	14	22	20	6	er	independent
seq1070_all_clean_seqs_gap0_no20_0.4	GGAGGTGGGGAGGAAGTTCTGAAACCACACACATTT	12	11	25	23	13	er	cooperative
seq1071_all_clean_seqs_gap0_no20_0.4	TGGCTACTGCAGCACTTCCTCCCGCAGCCCTGGGAC	17	15	22	20	5	er	independent
seq1072_all_clean_seqs_gap0_no20_0.4	CCCCAGGTTGCTTCCGTTCTGGGAACCGCGTCCTCG	13	11	26	24	13	er	independent
seq1074_all_clean_seqs_gap0_no20_0.4	CCCTACCTCTCCTTCCTGCCACAAGGGAAAGTCACT	14	12	19	17	5	er	independent
seq1305_all_clean_seqs_gap0_no20_0.4	CCCTACCTCTCCTTCCTGCCACAAGGGAAAGTCACT	14	12	19	17	5	er	independent
seq1075_all_clean_seqs_gap0_no20_0.4	GTCTTACTTCCTGTCCCCGCCCACCGCGACTGTCTT	9	7	24	22	15	er	independent
seq1077_all_clean_seqs_gap0_no20_0.4	CCCGGGGGTTGTCTTTTCCGCCGCAGCCGCGCGGGG	17	15	21	19	4	er	independent
seq1079_all_clean_seqs_gap0_no20_0.4	AGAATCGCATCAGGATGTGGTGAGGGAGCACATTTG	13	12	18	16	5	er	cooperative
seq1080_all_clean_seqs_gap0_no20_0.4	GTGCAGGCAATGAGGATGTTGTGGGGGAGACAGGGA	14	13	22	20	8	er	independent
seq1082_all_clean_seqs_gap0_no20_0.4	GAAGCGATATTTCCTCCTGGGGTTGACCGCCCCGTG	12	10	27	25	15	er	independent
seq1084_all_clean_seqs_gap0_no20_0.4	CTCAGCTCCGCGGAAGTTGCGGTAAGTGGAGCTTTG	12	11	20	18	8	er	cooperative
seq1085_all_clean_seqs_gap0_no20_0.4	ACAACCCGGAAGTTGGCGCAGCGCGGTTGCCAATGG	8	7	24	22	16	er	independent
seq1086_all_clean_seqs_gap0_no20_0.4	TGGCGCTTCCTGTCGCTACCGCTGCGGCCCAGGGCC	8	6	25	23	17	er	independent
seq1088_all_clean_seqs_gap0_no20_0.4	GCCATGGCCACTTCCTGCTTGTAACCACAGCCCAGA	13	11	25	23	12	er	cooperative
seq1089_all_clean_seqs_gap0_no20_0.4	GGGAGGAAGTGTGAAGGGACTTTTGTGGTGAGTGAT	5	4	26	24	21	er	cooperative
seq1090_all_clean_seqs_gap0_no20_0.4	CCAGAGCAGGATGTTCTGCTGTGGCTAGATAAGCCC	9	8	22	20	13	er	independent
seq1091_all_clean_seqs_gap0_no20_0.4	TATGGCGGGCAGGAAGTGCGGGTGCGCGCCTGCGCA	12	11	19	17	7	er	independent
seq1092_all_clean_seqs_gap0_no20_0.4	AATAAAGCTACAGACTTCCGCCCACAGGTCGCCGCT	17	15	22	20	5	er	independent
seq1308_all_clean_seqs_gap0_no20_0.4	AATAAAGCTACAGACTTCCGCCCACAGGTCGCCGCT	17	15	22	20	5	er	independent
seq1093_all_clean_seqs_gap0_no20_0.4	CCCAGCCCTTCCTGCAGGGTCGCTTGTGGGTCGGGT	10	8	27	25	17	er	independent
seq1094_all_clean_seqs_gap0_no20_0.4	TTTGTCATATCAACAGGATGTGGTTCTCCCCTGGTT	16	15	21	19	5	er	independent
seq1096_all_clean_seqs_gap0_no20_0.4	CCCCTCACTTCCCTCAACCCTTCCCACAAACTGGGA	10	8	24	22	14	er	independent
seq1099_all_clean_seqs_gap0_no20_0.4	AGCGCTTCCCCTTCCGCTGCCGCAGCCGCCGCCTCC	13	11	20	18	7	er	independent
seq1100_all_clean_seqs_gap0_no20_0.4	CCAGGCGTTTCCGGGTTCCCGCGGTCCCGTCCCCCA	10	8	22	20	12	er	ambiguous
seq1101_all_clean_seqs_gap0_no20_0.4	ATCTTACCCCGGAAATGACAACAGTGCCGCAAACTG	11	10	27	25	16	er	independent
seq1103_all_clean_seqs_gap0_no20_0.4	ACTCACACCACGGAAACTGCGGCTCGGCAGGCTGAG	12	11	20	18	8	er	independent
seq1105_all_clean_seqs_gap0_no20_0.4	CCTGGTCCGGAAGCGCTGTCCCCGCCTCCCGCATAG	9	8	29	27	20	er	independent
seq1106_all_clean_seqs_gap0_no20_0.4	AACAACTGACCGGACAGAACACAGCCACAAAACACG	12	11	25	23	13	er	independent
seq1312_all_clean_seqs_gap0_no20_0.4	AACAACTGACCGGACAGAACACAGCCACAAAACACG	12	11	25	23	13	er	independent
seq1107_all_clean_seqs_gap0_no20_0.4	GTAAAAGAGGAAGTAACACCTCCTTGCGGTTGAGAC	9	8	27	25	18	er	cooperative
seq1310_all_clean_seqs_gap0_no20_0.4	AATGTAGGAAATTCCACTGCATAATTTGTGGTAGTG	7	6	29	27	22	er	independent
seq1109_all_clean_seqs_gap0_no20_0.4	CAACTGACCGGACAGAACACAGCCACAAAACACGAG	10	9	23	21	13	er	independent
seq1311_all_clean_seqs_gap0_no20_0.4	CAACTGACCGGACAGAACACAGCCACAAAACACGAG	10	9	23	21	13	er	independent
seq3076_all_clean_seqs_gap0_no20_0.4	CAACTGACCGGACAGAACACAGCCACAAAACACGAG	10	9	23	21	13	er	independent
seq110_all_clean_seqs_gap0_no20_0.4	TGTCTTCAGGAAGTGTAGCAGGTGTTGAGGTCAAGC	9	8	28	26	19	er	independent
seq329_all_clean_seqs_gap0_no20_0.4	TGTCTTCAGGAAGTGTAGCAGGTGTTGAGGTCAAGC	9	8	28	26	19	er	cooperative
seq1110_all_clean_seqs_gap0_no20_0.4	AAAAGGCACCAGGAAATGACAGCACCGCAGCACGCC	12	11	25	23	13	er	independent
seq1111_all_clean_seqs_gap0_no20_0.4	GCCCCGGAAGTGGCCCGGCTGTTGGCCGCAGCGGGA	6	5	26	24	20	er	independent
seq1114_all_clean_seqs_gap0_no20_0.4	CTGTCCACATAAGGAAGTTGGGACCACAAGGTCTTT	13	12	24	22	11	er	independent
seq1315_all_clean_seqs_gap0_no20_0.4	CTGTCCACATAAGGAAGTTGGGACCACAAGGTCTTT	13	12	24	22	11	er	independent
seq1115_all_clean_seqs_gap0_no20_0.4	TTGCTGTCATCCTGTTCTCCCAGCTAAGCCACAGGA	10	8	29	27	19	er	independent
seq1116_all_clean_seqs_gap0_no20_0.4	AACTAGGCTTTTCTTTCCTGTGGTCCTTAAGGAGGC	16	14	21	19	5	er	independent
seq1117_all_clean_seqs_gap0_no20_0.4	CCACCGTCCCCGGAAATAACCGCGCCTGCCTCTCAA	12	11	20	18	8	er	ambiguous
seq1118_all_clean_seqs_gap0_no20_0.4	GCTCGGAAATACCAATATTGGGCTGTGGTATTTGAA	5	4	26	24	21	er	cooperative
seq1120_all_clean_seqs_gap0_no20_0.4	TGTATAACATCCTCATGTTCTGTGGGTGAGTTGAGC	10	8	23	21	13	er	ambiguous
seq1121_all_clean_seqs_gap0_no20_0.4	ACGGGGAAGAACGGAAGTGGTTTCCATGATGGTCTG	13	12	18	16	5	er	ambiguous
seq1316_all_clean_seqs_gap0_no20_0.4	ACGGGGAAGAACGGAAGTGGTTTCCATGATGGTCTG	13	12	18	16	5	er	cooperative
seq1123_all_clean_seqs_gap0_no20_0.4	GCCAGGAGGACTTCCGGGTGGGTGTGGTATCTGCGA	13	11	25	23	12	er	cooperative
seq1124_all_clean_seqs_gap0_no20_0.4	TCCAGTGCCGCCGCCGGAAAACCGCAGCGGCGGCGG	16	15	22	20	6	er	cooperative
seq1126_all_clean_seqs_gap0_no20_0.4	GCACCCTTCCTGCTTCCCACAGTGTGGTATAAGAGG	8	6	25	23	17	er	independent
seq1128_all_clean_seqs_gap0_no20_0.4	GAGATAGTCTGGAGGGGAAGTGGTTATAAGTGATAA	16	15	21	19	5	er	cooperative
seq1129_all_clean_seqs_gap0_no20_0.4	TGAGAAGGCAGGATAAGTGACCACATATTTATGCCA	11	10	21	19	10	er	independent
seq1130_all_clean_seqs_gap0_no20_0.4	CCCGCCACTTCCCTGCCTCTGCGGGAGCCCCCCAGC	10	8	22	20	12	er	independent
seq1131_all_clean_seqs_gap0_no20_0.4	CTCTCTGGGCGGAAGGAACGCGGTCACCCTGAGAAA	11	10	21	19	10	er	ambiguous
seq1132_all_clean_seqs_gap0_no20_0.4	GGGCTATTGTTTCCTCCCCCATGTGACCACAGCCTC	12	10	27	25	15	er	independent
seq1133_all_clean_seqs_gap0_no20_0.4	CTTCGCCGCTTCCAGGAAGGGCCACAACGGCCGTCG	15	14	22	20	7	er	independent
seq1134_all_clean_seqs_gap0_no20_0.4	GAGGAAGAGTCTTCCTGTAACCACTAGAGGGCGCTG	13	11	21	19	8	er	independent
seq1135_all_clean_seqs_gap0_no20_0.4	CCACCCTCCGTCCGGCCGCGACCGCGAGGAGGAAGA	11	9	22	20	11	er	independent
seq1136_all_clean_seqs_gap0_no20_0.4	CCCACTGATAAGACAGGATGTGGTAAAGAAGCCAGC	16	15	21	19	5	er	cooperative
seq1137_all_clean_seqs_gap0_no20_0.4	ACCTGCACTTCCTCCTCCCTAGACCGCACCCTTCTC	10	8	24	22	14	er	ambiguous
seq1138_all_clean_seqs_gap0_no20_0.4	GCCACTTCCGGTCACTCCCCGCTGCGGCCTCGCGCT	7	5	25	23	18	er	independent
seq113_all_clean_seqs_gap0_no20_0.4	TTGCTAGAGGAAGCGCTGCCCCGGCAGCCGCAGCCA	9	8	28	26	19	er	independent
seq1140_all_clean_seqs_gap0_no20_0.4	ATCCCACTATAGGAAGCTTCTCTGTGGTTTTGAGCC	12	11	25	23	13	er	cooperative
seq1142_all_clean_seqs_gap0_no20_0.4	CCGAGCTTAACGACATCCTGCGGCTCAGCGTGGAGG	16	14	21	19	5	er	independent
seq1143_all_clean_seqs_gap0_no20_0.4	CTTTGCAGGAAGCTGGGGTTCACCCACAGCCTTGTT	8	7	24	22	16	er	independent
seq1144_all_clean_seqs_gap0_no20_0.4	ACAACTTCCTGTGGGATTTTTGGTGTCTGCGGCTCA	7	5	30	28	23	er	independent
seq1145_all_clean_seqs_gap0_no20_0.4	CACTTCCTGCCCTCTTCCACTTTCAAAACCACATCA	5	3	29	27	24	er	cooperative
seq1146_all_clean_seqs_gap0_no20_0.4	GCACGTGTTTCCTGGGGCTGCACCACAGCACCACAC	10	8	23	21	13	er	independent
seq1147_all_clean_seqs_gap0_no20_0.4	GTTTATGGCAGGAAAGCCTGATAACCCACAAACCCT	11	10	26	24	15	er	ambiguous
seq1148_all_clean_seqs_gap0_no20_0.4	ACCTCTCTCACTTCCTACCAGAGAACCACAGCCAAG	13	11	26	24	13	er	ambiguous
seq1149_all_clean_seqs_gap0_no20_0.4	CCTCAATTTCCTGGCCAGAGAAACCACTGCCTCTCA	9	7	24	22	15	er	independent
seq114_all_clean_seqs_gap0_no20_0.4	CCCACATCCCGTGAGTCACCAGGTCCCACAAACCCT	7	5	26	24	19	er	independent
seq1150_all_clean_seqs_gap0_no20_0.4	CGAAGCCAGGAAATAAGGATAAACCACAGAAAGAAA	9	8	24	22	15	er	cooperative
seq1151_all_clean_seqs_gap0_no20_0.4	GAGTCTACAGCGGAAGCCACCACATGCCCCACCCCC	12	11	20	18	8	er	independent
seq1152_all_clean_seqs_gap0_no20_0.4	GGGGGAATGTAGGAAGTATCATCGCCCACAAGAAAG	12	11	26	24	14	er	cooperative
seq1153_all_clean_seqs_gap0_no20_0.4	GTGGGGGTGACAGGATGCGGGTAGAGGGCTCAGCCA	13	12	18	16	5	er	independent
seq1154_all_clean_seqs_gap0_no20_0.4	TAAGAAAAACAGTCATCCTGCGGTTTCCATTTGTGA	16	14	21	19	5	er	cooperative
seq1155_all_clean_seqs_gap0_no20_0.4	TCCCTCCTTCCGCTCTGGTTTTGTGGTTGCTTGCTG	9	7	24	22	15	er	cooperative
seq1156_all_clean_seqs_gap0_no20_0.4	GACAGACCTTAGGAAGTCGCGGTTTCATCAGGGCTT	12	11	20	18	8	er	cooperative
seq1157_all_clean_seqs_gap0_no20_0.4	GGCAACCCAAGGAAGTATCTCTGAAACCACACAACA	11	10	27	25	16	er	cooperative
seq1159_all_clean_seqs_gap0_no20_0.4	TGTAAGTCACTTCCTGTCGTGGTCAGGTCTCCTCTC	12	10	20	18	8	er	independent
seq115_all_clean_seqs_gap0_no20_0.4	TTTTCAGTCCGGAGATTCCGGCCACAACTATTTTTG	17	15	22	20	5	er	independent
seq1160_all_clean_seqs_gap0_no20_0.4	GATGAAAGAGGAAGTTCTCAAACCACCTTGCCAGTG	10	9	23	21	13	er	independent
seq1161_all_clean_seqs_gap0_no20_0.4	ACCATATCCTGAGAATGAACCATGTGGTGGATGCAC	7	5	25	23	18	er	independent
seq1162_all_clean_seqs_gap0_no20_0.4	AAACCAGAGGAAGTGGATTCCAACCACAAACCTCAC	9	8	24	22	15	er	cooperative
seq1163_all_clean_seqs_gap0_no20_0.4	ACTTACAAAGGAAGTGACAGAACCACAGAAAAGACC	10	9	23	21	13	er	cooperative
seq1164_all_clean_seqs_gap0_no20_0.4	CAGAGACACCTGCGGAAGCCACAGGGAGGTCACAGA	14	13	19	17	5	er	independent
seq1165_all_clean_seqs_gap0_no20_0.4	ACAGAGAAGCTTCCTATTGTGGGATTCACCACCACC	12	10	20	18	8	er	independent
seq1166_all_clean_seqs_gap0_no20_0.4	CTGGAAACCATTTCCTTTGTGGCCATGAAACAATGG	13	11	20	18	7	er	ambiguous
seq1167_all_clean_seqs_gap0_no20_0.4	AGGAGAAGGAAGAGGATGTTGAGGTTGGGGGAAACC	14	13	22	20	8	er	independent
seq1168_all_clean_seqs_gap0_no20_0.4	AATATAGGAAGTGTCAGCTAGGGAACTCAACCACAA	7	6	31	29	24	er	independent
seq1169_all_clean_seqs_gap0_no20_0.4	CAACAAGAGGAAATCAGAAACACTGAAGCCACAGCT	9	8	29	27	20	er	independent
seq116_all_clean_seqs_gap0_no20_0.4	TCGCATAGCCGGGAAGCGCGGTGGAGGTTGTTGGGG	12	11	19	17	7	er	independent
seq1170_all_clean_seqs_gap0_no20_0.4	GCATGTTCAAAAGGATGTGGGTGCTTACCTAGTGCC	13	12	18	16	5	er	cooperative
seq1171_all_clean_seqs_gap0_no20_0.4	GTCCCCGTAACAGGATGTGGTGAGCTGTTATACCAC	13	12	18	16	5	er	cooperative
seq1172_all_clean_seqs_gap0_no20_0.4	TTCATTTCTACCTTCCTGTGGTCTTTTTGCCTCCGA	14	12	19	17	5	er	independent
seq1173_all_clean_seqs_gap0_no20_0.4	GCAGAGAGATTGGCCGGATGCGGTGGCTCACGCCTT	16	15	21	19	5	er	cooperative
seq1174_all_clean_seqs_gap0_no20_0.4	GGTCTGGAGGATGTTTGCAGCTGCTGTGGGTGGTGG	9	8	27	25	18	er	independent
seq1175_all_clean_seqs_gap0_no20_0.4	GGAGGGCTTCCTGCCCACCACCACCCACAGCAGCTG	9	7	25	23	16	er	independent
seq1176_all_clean_seqs_gap0_no20_0.4	TCCGGAAGTGGCACTGATGGGCGCCTGCGGCGGGGG	4	3	28	26	24	er	independent
seq1177_all_clean_seqs_gap0_no20_0.4	AATGCCGGATATTGGTTCTGGTAAGCCACAAAAAAG	7	6	26	24	19	er	cooperative
seq1178_all_clean_seqs_gap0_no20_0.4	CTGTCCCTAGCAGGATGTGGTTTGCACATTGCTGCT	13	12	18	16	5	er	cooperative
seq1179_all_clean_seqs_gap0_no20_0.4	GCAGTCGCTAAGGGCGGAAACCACTGTTTGGGAGCT	16	15	21	19	5	er	cooperative
seq1180_all_clean_seqs_gap0_no20_0.4	CGGGGGCCAGGCTTCCTGTGGTGGGAGCGGCAGGCC	14	12	19	17	5	er	independent
seq1181_all_clean_seqs_gap0_no20_0.4	CTTAGCACTTCAGCCGGAAACCACAGCATACATTTC	16	15	21	19	5	er	cooperative
seq1182_all_clean_seqs_gap0_no20_0.4	CTTGTGAAATGTATCCTGTGGTTGCCGGCTGAAGTG	14	12	19	17	5	er	independent
seq1183_all_clean_seqs_gap0_no20_0.4	GAGGGACAGGATGCCGCCAGGAACCACAAGAGCTTC	9	8	24	22	15	er	cooperative
seq1289_all_clean_seqs_gap0_no20_0.4	GAGGGACAGGATGCCGCCAGGAACCACAAGAGCTTC	9	8	24	22	15	er	cooperative
seq1184_all_clean_seqs_gap0_no20_0.4	ATGGGTACAGGATTTCCTTTTGTGGTGATGAAAATG	15	13	23	21	8	er	cooperative
seq1185_all_clean_seqs_gap0_no20_0.4	CAGCGGAAGAAAGACCTGCCACCTCCACCACAAAGA	5	4	28	26	23	er	independent
seq1186_all_clean_seqs_gap0_no20_0.4	TGGGGACCACTGTCAGGATGTGGTCACTGGAGTCAC	16	15	21	19	5	er	cooperative
seq1187_all_clean_seqs_gap0_no20_0.4	CGGGGACCACTGTCAGGATGTGGTCACTGGAGTCAC	16	15	21	19	5	er	cooperative
seq1188_all_clean_seqs_gap0_no20_0.4	TATTCTTCCTGTACTTAAGCTTGCTGGTGTGGTTTC	7	5	30	28	23	er	independent
seq1189_all_clean_seqs_gap0_no20_0.4	AGAAAAGGAAATGGTGGGCTGCACACCACAGCTCAC	7	6	26	24	19	er	independent
seq118_all_clean_seqs_gap0_no20_0.4	AGCCCTCTGCAACTTCCCGGCCCCACAGCCCCACCC	15	13	23	21	8	er	independent
seq1190_all_clean_seqs_gap0_no20_0.4	CACTTCCTGTCAAAGCCAGTTCCTTAACCGCTTAGG	5	3	28	26	23	er	cooperative
seq1191_all_clean_seqs_gap0_no20_0.4	CAGGTTGTTGAGGATGTGGAGAAACCGCAACCTCGT	12	11	25	23	13	er	cooperative
seq1192_all_clean_seqs_gap0_no20_0.4	CCAGGGCCGGAAGTGCTGGTGGTGGTTTCCATCATG	9	8	23	21	14	er	independent
seq1193_all_clean_seqs_gap0_no20_0.4	TGGGCTTTGCAGGAAGCTGTGGTTCACCTACAGCCT	12	11	20	18	8	er	cooperative
seq1194_all_clean_seqs_gap0_no20_0.4	AGTTGGTTCCTTCCGGTGGGTTTGTGGGCTTGGGGT	12	10	25	23	13	er	independent
seq1195_all_clean_seqs_gap0_no20_0.4	GCAACTGAACAGGAAACTAAAAAACCACAACACTTA	12	11	25	23	13	er	cooperative
seq1196_all_clean_seqs_gap0_no20_0.4	CCCTCACCCCAGCTTTCCTGTGGTTAACCAAACCCC	16	14	21	19	5	er	cooperative
seq1197_all_clean_seqs_gap0_no20_0.4	TTTGATCTTTGGGAAGTGGCCTGTGGTTCTTATCAC	12	11	24	22	12	er	cooperative
seq1198_all_clean_seqs_gap0_no20_0.4	GTGTGAAGGAAGTGTGAGATCAAACCACAGCTGGGT	8	7	25	23	17	er	cooperative
seq1199_all_clean_seqs_gap0_no20_0.4	TGGAAGAGGGCAGGAAGTGTTGTGGTCACTCCCACC	13	12	23	21	10	er	cooperative
seq119_all_clean_seqs_gap0_no20_0.4	AGGGTGTACTCGGAAGTTTCGAGTGGTTGCTTGGTT	12	11	24	22	12	er	independent
seq1200_all_clean_seqs_gap0_no20_0.4	CAAGGGAACATCCTTAAACAGCTTGTGGTATTGCTG	11	9	26	24	15	er	cooperative
seq1201_all_clean_seqs_gap0_no20_0.4	TGTTGTAGGGGAAGTGGTGTGTGGTATTCCTGGGGA	10	9	22	20	12	er	cooperative
seq1202_all_clean_seqs_gap0_no20_0.4	GAGGTTGGGAAGTTCTTCCTTTGGTCTGACCACAGT	8	7	30	28	22	er	independent
seq1203_all_clean_seqs_gap0_no20_0.4	TACGGGAACTTCCTTTTCTTGTGGTGTGGCCGGGTC	11	9	22	20	11	er	independent
seq1204_all_clean_seqs_gap0_no20_0.4	TTTTCCCACTTCCTAGGTTGTGGTGGGGATTACACA	11	9	21	19	10	er	cooperative
seq1205_all_clean_seqs_gap0_no20_0.4	CACTGCGGAAGCAGTGTAGAGAGGTGGTTATCAGTG	7	6	25	23	18	er	independent
seq1206_all_clean_seqs_gap0_no20_0.4	CTGCTGCTTTTAGGATGTGGTTTTATTATTGTCGGG	13	12	18	16	5	er	cooperative
seq1207_all_clean_seqs_gap0_no20_0.4	GAGAAACAGGAAGAGGGGTGGTGGTTACGGAACACG	9	8	22	20	13	er	cooperative
seq1208_all_clean_seqs_gap0_no20_0.4	GAAAGCACGTGTTTCCTGCGGCTGCACCCCAGCACC	14	12	19	17	5	er	independent
seq1209_all_clean_seqs_gap0_no20_0.4	ACACCGCTCAGGAAGACAAAGCCACACCTCACACCG	11	10	22	20	11	er	ambiguous
seq120_all_clean_seqs_gap0_no20_0.4	TTTATCATGAATGCAGGATGTGGGCAGACTCACAGC	16	15	21	19	5	er	cooperative
seq1212_all_clean_seqs_gap0_no20_0.4	GGCAAACAGGAAACACTCCCAGGGCTGTGGGCTCCT	9	8	28	26	19	er	independent
seq1213_all_clean_seqs_gap0_no20_0.4	GACCCATTTCCTGGCTCAGGAGCCCACAGCCCTGGG	9	7	24	22	15	er	independent
seq1214_all_clean_seqs_gap0_no20_0.4	GGGCTCCCAGAAGGATGTGGTTTCTGAGTACGTTGG	13	12	18	16	5	er	cooperative
seq1296_all_clean_seqs_gap0_no20_0.4	GGGCTCCCAGAAGGATGTGGTTTCTGAGTACGTTGG	13	12	18	16	5	er	cooperative
seq1215_all_clean_seqs_gap0_no20_0.4	ACCAGCAACGGAAATCAGATCTCTTGTGGTTATTAT	10	9	27	25	17	er	cooperative
seq1216_all_clean_seqs_gap0_no20_0.4	CTCAGGTTATCTAGGAAATCTACCGCACGCTAAAGT	14	13	23	21	9	er	independent
seq1217_all_clean_seqs_gap0_no20_0.4	CAAGCCAGGAAGAGGGCCCTCACCAGAAACCGCACT	8	7	30	28	22	er	cooperative
seq1219_all_clean_seqs_gap0_no20_0.4	GACCTGCACTGTCAAGGATGTGGTTGCTGATGTTTC	16	15	21	19	5	er	cooperative
seq121_all_clean_seqs_gap0_no20_0.4	AGGTACTCACCATTCCGGCGGTTGCTACTGTCACTG	14	12	19	17	5	er	independent
seq1220_all_clean_seqs_gap0_no20_0.4	CAGCAAAAGGCAGGATGTGGTTAAAACTGTGCTCTG	13	12	18	16	5	er	cooperative
seq1222_all_clean_seqs_gap0_no20_0.4	CCAAAATTGCCACGGAAACCACATCTTTCAGGCGAG	14	13	19	17	5	er	ambiguous
seq1223_all_clean_seqs_gap0_no20_0.4	TCTCCTTTCAGGAAGCTGCACCCAAACCACCCTCAG	11	10	27	25	16	er	ambiguous
seq1227_all_clean_seqs_gap0_no20_0.4	ATTTAGGAGGAAGTTTCCAGTACCACAACCTCACAG	9	8	23	21	14	er	independent
seq1228_all_clean_seqs_gap0_no20_0.4	CGTCTAATTGCAGGAAGTGGTTTGAAATGTTAATCT	13	12	18	16	5	er	cooperative
seq1229_all_clean_seqs_gap0_no20_0.4	GTGGGTTTAGGATATGGGTGTGGTTTCTAATTGTCT	10	9	21	19	11	er	independent
seq122_all_clean_seqs_gap0_no20_0.4	GGTCCCCCCGGTTCCGGCGCGGTTGAGGCCTTCGGT	13	11	20	18	7	er	ambiguous
seq1230_all_clean_seqs_gap0_no20_0.4	AGACAGGAGTTCAGGAAGCTGCGGTCTAGATTATGT	14	13	22	20	8	er	cooperative
seq1231_all_clean_seqs_gap0_no20_0.4	GACACGTCTTTGGAAGGATGTGGTTGCCGTGGGTTT	16	15	21	19	5	er	cooperative
seq1232_all_clean_seqs_gap0_no20_0.4	GTTGAAATTGAGCTTCCGTTGGTGGTTAACCCTCTG	15	13	23	21	8	er	independent
seq1233_all_clean_seqs_gap0_no20_0.4	ACAGATGGTCCGGAACTTCAGAAAACCACTCATTGT	12	11	26	24	14	er	independent
seq1234_all_clean_seqs_gap0_no20_0.4	AAAGAACTTCCTGAGGTGCTTGAGGTTAGGCTATGG	9	7	23	21	14	er	ambiguous
seq1235_all_clean_seqs_gap0_no20_0.4	TAAATGTTTCCTAAAAGCTCTTTCATAAACCACAGT	9	7	30	28	21	er	independent
seq1236_all_clean_seqs_gap0_no20_0.4	AGTTACAGTAAAGGATGTGGTGAAACAGATGTTTAT	13	12	18	16	5	er	cooperative
seq1239_all_clean_seqs_gap0_no20_0.4	CATCAAGTATTTCCTCACGCAAGCAACCGCATCCAT	12	10	27	25	15	er	cooperative
seq123_all_clean_seqs_gap0_no20_0.4	CCCGCGACACAAGGCGGATGTGGTACCCTCACTTGT	16	15	21	19	5	er	cooperative
seq1240_all_clean_seqs_gap0_no20_0.4	TGGGGTTTCCTGGGGAGAAACTTAGCCCTACCACAC	8	6	31	29	23	er	independent
seq1241_all_clean_seqs_gap0_no20_0.4	GTCTTCCTTCCTGAGAATCTTAACCACCAGCTTGCC	9	7	24	22	15	er	independent
seq1242_all_clean_seqs_gap0_no20_0.4	GCGCGGGAGGAAGCCCCCCAATAATTGCGGGGCTTC	9	8	28	26	19	er	independent
seq1244_all_clean_seqs_gap0_no20_0.4	ACCCAGGGGACTTCCTGGCTCAGTGCCACAACCCAG	13	11	26	24	13	er	independent
seq1245_all_clean_seqs_gap0_no20_0.4	ATAAAGGATGTACAGTATTTAGAGAACAGTGGTTAA	6	5	30	28	24	er	independent
seq1246_all_clean_seqs_gap0_no20_0.4	GCCACACTGGCGGAAATGGTGGTTACTGTTCGAGCC	12	11	20	18	8	er	cooperative
seq1247_all_clean_seqs_gap0_no20_0.4	TGGGGAACGCTGCGGATGCTGCGGTAAACCATGCGA	14	13	22	20	8	er	cooperative
seq1248_all_clean_seqs_gap0_no20_0.4	ATCTCCACATCCTCCCCATCGACCGCATGGTTTACC	10	8	23	21	13	er	independent
seq1249_all_clean_seqs_gap0_no20_0.4	GCAGTCAGAAGGTGCGGATGCGGTAAGGTATGCGCT	16	15	21	19	5	er	cooperative
seq124_all_clean_seqs_gap0_no20_0.4	AAAGGGCTCCAGGGATGTTCTGAGGTTTACAGGCTG	13	12	23	21	10	er	independent
seq1250_all_clean_seqs_gap0_no20_0.4	AACTTCCGAGGGAACTAACTGGTTTTAACCACATTG	5	3	29	27	24	er	cooperative
seq1251_all_clean_seqs_gap0_no20_0.4	TTCAACAGGATATTGCTTTGTTACCACAGGCCCTTT	8	7	24	22	16	er	cooperative
seq1252_all_clean_seqs_gap0_no20_0.4	TGGCTTGAGCTCAGGAAGTTGTGGCTGCAGTAAGCT	14	13	22	20	8	er	independent
seq1253_all_clean_seqs_gap0_no20_0.4	CCTCCCTGAGGGGGAAGTGGTTTTTGAGTCTGAGTC	13	12	18	16	5	er	independent
seq1255_all_clean_seqs_gap0_no20_0.4	AGAAGCTTCTACAGGAAACCACTAATGGAGACAGAG	14	13	19	17	5	er	independent
seq1256_all_clean_seqs_gap0_no20_0.4	GTTTCTCTGGCCAGGAAATTGAGGTTTCTGTTAGTC	14	13	22	20	8	er	independent
seq1257_all_clean_seqs_gap0_no20_0.4	TGACTTCCTCCTCTTCACTAACAGAAACCTCAATTT	6	4	28	26	22	er	independent
seq1258_all_clean_seqs_gap0_no20_0.4	TTTATCCTTATTTCCTGGCTTCGCCCACAAGCACAG	13	11	25	23	12	er	independent
seq1259_all_clean_seqs_gap0_no20_0.4	GGGGCTGGGAAAGGATGTGGTAAGGGCCAGTCAGTC	13	12	18	16	5	er	cooperative
seq1260_all_clean_seqs_gap0_no20_0.4	GGGACAGACTCTCCAGGATGTGGTTGGATTTTGGGC	16	15	21	19	5	er	cooperative
seq1261_all_clean_seqs_gap0_no20_0.4	AGAAGCTGCAGTCCCGGAAGCGGTTTTAGGGGGCCG	16	15	21	19	5	er	cooperative
seq1318_all_clean_seqs_gap0_no20_0.4	AGAAGCTGCAGTCCCGGAAGCGGTTTTAGGGGGCCG	16	15	21	19	5	er	cooperative
seq1264_all_clean_seqs_gap0_no20_0.4	GAAAACTAAGCAGGATGTGGTCTCGGCTGGAGCCTG	13	12	18	16	5	er	cooperative
seq1266_all_clean_seqs_gap0_no20_0.4	ACAGCGCCTCTTCCTGCTCTACCACATCTGATGTCC	12	10	22	20	10	er	independent
seq1267_all_clean_seqs_gap0_no20_0.4	CCTCTCAACAGCATTTCCTGGTGGTCAGATATCTGA	16	14	22	20	6	er	independent
seq1268_all_clean_seqs_gap0_no20_0.4	ACCTGTAGGCGGAAGTCTGTGGCTTTATTTACACAG	11	10	20	18	9	er	cooperative
seq790_all_clean_seqs_gap0_no20_0.4	ACCTGTAGGCGGAAGTCTGTGGCTTTATTTACACAG	11	10	20	18	9	er	cooperative
seq1269_all_clean_seqs_gap0_no20_0.4	AGCCACGGACTTCCGCCTACAGGTCGCCGCAGGTCC	12	10	27	25	15	er	cooperative
seq791_all_clean_seqs_gap0_no20_0.4	AGCCACGGACTTCCGCCTACAGGTCGCCGCAGGTCC	12	10	27	25	15	er	independent
seq1271_all_clean_seqs_gap0_no20_0.4	GTGGGAGCGGAAGCCTGAGCGGCCTGCGGCCTCCGG	9	8	27	25	18	er	independent
seq796_all_clean_seqs_gap0_no20_0.4	GTGGGAGCGGAAGCCTGAGCGGCCTGCGGCCTCCGG	9	8	27	25	18	er	independent
seq1275_all_clean_seqs_gap0_no20_0.4	GTCCTCCACTATTGTTTCCGGCCGCAGCAGAGGCGG	17	15	22	20	5	er	independent
seq2153_all_clean_seqs_gap0_no20_0.4	GTCCTCCACTATTGTTTCCGGCCGCAGCAGAGGCGG	17	15	22	20	5	er	independent
seq1276_all_clean_seqs_gap0_no20_0.4	GCATTTCTCAGAAAAGGAAGCGGTTGTGCCGGGAGG	16	15	21	19	5	er	cooperative
seq2185_all_clean_seqs_gap0_no20_0.4	GCATTTCTCAGAAAAGGAAGCGGTTGTGCCGGGAGG	16	15	21	19	5	er	independent
seq1278_all_clean_seqs_gap0_no20_0.4	AAAGTAGGTCCGGTCCGCGGGTGCGGTCGGGCATGC	9	7	24	22	15	er	independent
seq2227_all_clean_seqs_gap0_no20_0.4	AAAGTAGGTCCGGTCCGCGGGTGCGGTCGGGCATGC	9	7	24	22	15	er	independent
seq1279_all_clean_seqs_gap0_no20_0.4	GATTGTTATGTCCGGAAACCGCTTATCAGAGCCCTG	14	13	19	17	5	er	cooperative
seq839_all_clean_seqs_gap0_no20_0.4	GATTGTTATGTCCGGAAACCGCTTATCAGAGCCCTG	14	13	19	17	5	er	independent
seq1280_all_clean_seqs_gap0_no20_0.4	CGGGACCTGTTTCCTTGGGAACCACAAGATAAGACC	12	10	22	20	10	er	independent
seq840_all_clean_seqs_gap0_no20_0.4	CGGGACCTGTTTCCTTGGGAACCACAAGATAAGACC	12	10	22	20	10	er	independent
seq1282_all_clean_seqs_gap0_no20_0.4	GCCCACCCGCTTCCGGTTGTGGGCCCCGCCCGCCGA	12	10	20	18	8	er	cooperative
seq860_all_clean_seqs_gap0_no20_0.4	GCCCACCCGCTTCCGGTTGTGGGCCCCGCCCGCCGA	12	10	20	18	8	er	independent
seq1283_all_clean_seqs_gap0_no20_0.4	AAAGACAGGATGTGGGGGAGTGAGCCACAAGGGCCC	8	7	25	23	17	er	ambiguous
seq2293_all_clean_seqs_gap0_no20_0.4	AAAGACAGGATGTGGGGGAGTGAGCCACAAGGGCCC	8	7	25	23	17	er	independent
seq1285_all_clean_seqs_gap0_no20_0.4	TGCCACGTCCGCCATCTTGAAACAACCGCCACTCGG	8	6	26	24	18	er	independent
seq1286_all_clean_seqs_gap0_no20_0.4	GATATGGCAGGAAGTAGGGCCTGGAAACCGCACGGC	10	9	28	26	18	er	cooperative
seq894_all_clean_seqs_gap0_no20_0.4	GATATGGCAGGAAGTAGGGCCTGGAAACCGCACGGC	10	9	28	26	18	er	cooperative
seq1287_all_clean_seqs_gap0_no20_0.4	CGCCCTCCGGAAGAGAGGGCGGACCGCGGCCGCGCA	9	8	24	22	15	er	independent
seq2387_all_clean_seqs_gap0_no20_0.4	CGCCCTCCGGAAGAGAGGGCGGACCGCGGCCGCGCA	9	8	24	22	15	er	cooperative
seq1291_all_clean_seqs_gap0_no20_0.4	GACAATGAGCGCACAGGATGTGGTTTGGCGGCAGGG	16	15	21	19	5	er	cooperative
seq2530_all_clean_seqs_gap0_no20_0.4	GACAATGAGCGCACAGGATGTGGTTTGGCGGCAGGG	16	15	21	19	5	er	cooperative
seq1293_all_clean_seqs_gap0_no20_0.4	GGCTGCGACTTCCGGACTGCTCCTGGCCGCAGGGGG	11	9	27	25	16	er	independent
seq2559_all_clean_seqs_gap0_no20_0.4	GGCTGCGACTTCCGGACTGCTCCTGGCCGCAGGGGG	11	9	27	25	16	er	cooperative
seq1294_all_clean_seqs_gap0_no20_0.4	CAGTGGCTAAGGATCCGGTGTTGCGGTGATACATGA	14	12	24	22	10	er	cooperative
seq960_all_clean_seqs_gap0_no20_0.4	CAGTGGCTAAGGATCCGGTGTTGCGGTGATACATGA	14	12	24	22	10	er	independent
seq1295_all_clean_seqs_gap0_no20_0.4	AAACATCATAGGAAGTGGATTTTGTGGTGAGAGACA	11	10	25	23	14	er	cooperative
seq2731_all_clean_seqs_gap0_no20_0.4	AAACATCATAGGAAGTGGATTTTGTGGTGAGAGACA	11	10	25	23	14	er	cooperative
seq1297_all_clean_seqs_gap0_no20_0.4	AACCCCAAAACGGAAACACCGGAGCCACAAGCTGAG	12	11	25	23	13	er	independent
seq2815_all_clean_seqs_gap0_no20_0.4	AACCCCAAAACGGAAACACCGGAGCCACAAGCTGAG	12	11	25	23	13	er	independent
seq129_all_clean_seqs_gap0_no20_0.4	AGGAGTGACGAGGCGGACGTGCGGGGGCGGGGGTGT	15	14	22	20	7	er	independent
seq1301_all_clean_seqs_gap0_no20_0.4	GGTCTCACCGCTCTTCCGCTTGCGGTTTCGGGGGCC	15	13	23	21	8	er	cooperative
seq1304_all_clean_seqs_gap0_no20_0.4	GTGGCGGGGCGGAAGTTCACATGTGTGGTATGTAGA	11	10	26	24	15	er	independent
seq2991_all_clean_seqs_gap0_no20_0.4	GTGGCGGGGCGGAAGTTCACATGTGTGGTATGTAGA	11	10	26	24	15	er	independent
seq1306_all_clean_seqs_gap0_no20_0.4	TGGAATTGAAAGGAAGCTGGCGCCACCGCAGAGGAC	12	11	26	24	14	er	cooperative
seq1309_all_clean_seqs_gap0_no20_0.4	TGAAGTTGGTGTTTTCCGGGGGCGGTTTTTCCATTG	15	13	23	21	8	er	independent
seq1314_all_clean_seqs_gap0_no20_0.4	TAAGCAGGGAATAGAGGAAGTGGTTTTGTCTCAGGC	16	15	21	19	5	er	cooperative
seq3095_all_clean_seqs_gap0_no20_0.4	TAAGCAGGGAATAGAGGAAGTGGTTTTGTCTCAGGC	16	15	21	19	5	er	cooperative
seq1321_all_clean_seqs_gap0_no20_0.4	CCGCCTCCGGAAGAATTCTCTGCGGGCATGTTGCTG	9	8	23	21	14	er	independent
seq1322_all_clean_seqs_gap0_no20_0.4	GTAAAAGGAAGTAAAGGCTTGGCCGGGCGCGGTGGC	7	6	30	28	23	er	independent
seq1323_all_clean_seqs_gap0_no20_0.4	GGGGGAGTTTTCGGAAGCGCTAACCGCGTTGGGGCC	13	12	24	22	11	er	cooperative
seq1324_all_clean_seqs_gap0_no20_0.4	AATCGCGCAGTTCCGCAGCTGCCGCCCCACAACCGT	12	10	27	25	15	er	independent
seq1326_all_clean_seqs_gap0_no20_0.4	AAACAGGAAATCACAGCAGCGTTGCGGAGTGGAGCA	6	5	25	23	19	er	independent
seq1327_all_clean_seqs_gap0_no20_0.4	ATGCAGAAGCTACAGGAAGAAGCCGCAGGCCAAGCT	15	14	23	21	8	er	independent
seq1328_all_clean_seqs_gap0_no20_0.4	ACTTGGCAGTTCCGGGTCCGCGCCCCACCGCGCCAC	11	9	28	26	17	er	independent
seq1329_all_clean_seqs_gap0_no20_0.4	CACTTCCCCCAGCCTCTCTTTTTAATACCACAATAG	5	3	28	26	23	er	cooperative
seq132_all_clean_seqs_gap0_no20_0.4	GCCCCTCTTCCTGACTCACACAACCGCCTCTAGTCT	9	7	24	22	15	er	independent
seq1330_all_clean_seqs_gap0_no20_0.4	TACCTACAGGAAATGAGACACACCGCAGGCCGATCC	9	8	23	21	14	er	cooperative
seq1331_all_clean_seqs_gap0_no20_0.4	TGTCTCATTTCCTGTAGGTAACAGGCACCACAATAG	10	8	28	26	18	er	independent
seq1333_all_clean_seqs_gap0_no20_0.4	CTCCCACATCCGAAGCGGCGCAACCCACAACAGCCT	9	7	25	23	16	er	ambiguous
seq1334_all_clean_seqs_gap0_no20_0.4	AGACCCGGAAGAACTTGTCCCAGTGTTGACCACACC	7	6	30	28	23	er	cooperative
seq1335_all_clean_seqs_gap0_no20_0.4	TGCTTCCCTTCCGTTCCGACAGCGAAAACCGCTGCC	10	8	29	27	19	er	independent
seq1337_all_clean_seqs_gap0_no20_0.4	CAAGCACATTACGGAAGAGGCTGACCGCAAATACGA	13	12	25	23	12	er	cooperative
seq1338_all_clean_seqs_gap0_no20_0.4	TTGGTCAGGATGTGGCTGAAGAAGCCACAAGAAAAA	8	7	25	23	17	er	cooperative
seq1341_all_clean_seqs_gap0_no20_0.4	GAAGTGTGCTCTTCCGGTACCTGCGGTTCGTTGCGC	13	11	24	22	11	er	cooperative
seq1342_all_clean_seqs_gap0_no20_0.4	CCTCCAGGAAGCGATAAGTGACTGTGGTGGAGAGAG	7	6	25	23	18	er	independent
seq1343_all_clean_seqs_gap0_no20_0.4	GCACTCGGATGTTGGCCGTAGTTGTGGTTATAGTTG	7	6	25	23	18	er	cooperative
seq1344_all_clean_seqs_gap0_no20_0.4	TACCTACATCCTGCCACCACCCGAGGGGACCGCAAG	9	7	30	28	21	er	cooperative
seq1345_all_clean_seqs_gap0_no20_0.4	TGGCAGAGCACATCCTGTGCGGTTTTCAGTTTTGCT	13	11	20	18	7	er	cooperative
seq1347_all_clean_seqs_gap0_no20_0.4	CGCCGTAGGAGGAAGCCGCGGCCGCAACGCTCCTGG	11	10	22	20	11	er	cooperative
seq1349_all_clean_seqs_gap0_no20_0.4	CTGTCCGCTACATCCGGGACCTGCGGGACCGCCGAT	13	11	24	22	11	er	independent
seq1352_all_clean_seqs_gap0_no20_0.4	AAAGGGAAGTTGGCGGGAGTTCAAAACCACCGGGGC	5	4	27	25	22	er	independent
seq1353_all_clean_seqs_gap0_no20_0.4	TCGTGAAAAAGGAAGTGGATAAAGTGGTTACGGCAA	11	10	25	23	14	er	ambiguous
seq1354_all_clean_seqs_gap0_no20_0.4	AGGCCGCCTACAGGATGTTGGAAACCACAGGGCCCG	13	12	25	23	12	er	cooperative
seq1356_all_clean_seqs_gap0_no20_0.4	CCTCCTCTTCCTCCCCACTCTGCACATGCGGCTGGG	9	7	29	27	20	er	independent
seq1357_all_clean_seqs_gap0_no20_0.4	AACAAACCGGATGGGGTTGCCACCCGCAATCTTGTC	9	8	24	22	15	er	cooperative
seq1358_all_clean_seqs_gap0_no20_0.4	CGGGTTGGGCAGGAAGCAGCATGACCGCAGTGGGTC	12	11	25	23	13	er	cooperative
seq1359_all_clean_seqs_gap0_no20_0.4	GCTCCCGGATGTTCTGGGGATCTGCGGCCGCCTGGC	7	6	25	23	18	er	cooperative
seq135_all_clean_seqs_gap0_no20_0.4	GGGGCAGCTTCCGGCAGGAGAGCCCGCATTCCCGGC	10	8	24	22	14	er	independent
seq1361_all_clean_seqs_gap0_no20_0.4	AAAGAGGAAATCACGTACCCGAAAACCACATGCACA	6	5	26	24	20	er	cooperative
seq1362_all_clean_seqs_gap0_no20_0.4	TACTAGTTTGGGGCATCCTGTGGTATAGGGGAAGCA	16	14	21	19	5	er	independent
seq1363_all_clean_seqs_gap0_no20_0.4	TCCAGGAAGGGGCAGGGGCCTGCTTGTGGGTTTAAA	5	4	27	25	22	er	independent
seq1364_all_clean_seqs_gap0_no20_0.4	AAGACAACATCCTGCCGGCACAGCCTGCGGGTTACT	10	8	28	26	18	er	cooperative
seq1365_all_clean_seqs_gap0_no20_0.4	CCTGGGGGGCCGGAAGCCCCGCTGCGGCCCCAGCCC	12	11	25	23	13	er	independent
seq1366_all_clean_seqs_gap0_no20_0.4	CACCCTCAACTTCCTGACCCATAAACCACAAGCTAT	12	10	26	24	14	er	cooperative
seq1367_all_clean_seqs_gap0_no20_0.4	GACCACTTCCTTTCTGTGTTTTGTGGTTTCACAACT	8	6	24	22	16	er	cooperative
seq1368_all_clean_seqs_gap0_no20_0.4	GCAGCATTTCCTGACTTCTTCGCCCCTGTGGTTGCA	9	7	29	27	20	er	independent
seq1369_all_clean_seqs_gap0_no20_0.4	GGGATCCTTCCGCTCCGGGTTAACCCCGACCGCGCC	9	7	30	28	21	er	independent
seq136_all_clean_seqs_gap0_no20_0.4	GTAAACTAGCTCTTCCGGTCTGTGGCCCTCACAGGA	14	12	23	21	9	er	independent
seq1371_all_clean_seqs_gap0_no20_0.4	GTGGCTTCCTGCCATTGACAATTGCGGGATGGCTTT	7	5	25	23	18	er	independent
seq1372_all_clean_seqs_gap0_no20_0.4	GGCGGATGGGGAGAAGAGAGTGGCTGTGGTCTCTGG	4	3	27	25	23	er	independent
seq1373_all_clean_seqs_gap0_no20_0.4	TGACATTTCCGGCCCCACCTCGGCCCGCAGCGCCGC	8	6	25	23	17	er	independent
seq1375_all_clean_seqs_gap0_no20_0.4	GCCACCGTATTTCCGCGTTTTTCGCGGTAGGCGGGA	12	10	25	23	13	er	ambiguous
seq1376_all_clean_seqs_gap0_no20_0.4	GCAGTGCAGGAAGTGCTTTGTGTGGTACAATCCCAA	9	8	23	21	14	er	independent
seq1377_all_clean_seqs_gap0_no20_0.4	CCAGAGCACATCCTACACGCACCACAACCTGAAAAC	11	9	22	20	11	er	independent
seq1378_all_clean_seqs_gap0_no20_0.4	CCAGGATGTAGTTTGGCCACTATTGAGTGGTTTGTT	4	3	28	26	24	er	independent
seq1379_all_clean_seqs_gap0_no20_0.4	GATTAAGAGGAAGTGTGTGTGATTATTACCGCTGGA	9	8	29	27	20	er	independent
seq137_all_clean_seqs_gap0_no20_0.4	AGGCGCCGGAAAAACTACATCTCCCACAATCCTCGG	8	7	24	22	16	er	independent
seq1380_all_clean_seqs_gap0_no20_0.4	TTTACTGAGAGGAAGTGGTTCTTGTGGGTGAAGGTC	11	10	25	23	14	er	cooperative
seq1381_all_clean_seqs_gap0_no20_0.4	GGTCTCTGCTTCCGGTCCTTGTGGTAGCACCTCTGT	11	9	22	20	11	er	independent
seq1382_all_clean_seqs_gap0_no20_0.4	GAGGAGGAAGTGCGCTGGCTGTTCTGCTGCGGGCCG	6	5	30	28	24	er	independent
seq1383_all_clean_seqs_gap0_no20_0.4	CACCTCCTACTTCCCCCCGCTGATAACCACCAACCC	12	10	27	25	15	er	independent
seq1384_all_clean_seqs_gap0_no20_0.4	GAGCAGGAAGCACCCCCAGCACAGGCCTGCGGTGAG	6	5	30	28	24	er	cooperative
seq1385_all_clean_seqs_gap0_no20_0.4	CTCACTCATCTGACTTCCTGCGGTTTACGACAACAG	16	14	21	19	5	er	independent
seq1386_all_clean_seqs_gap0_no20_0.4	AAAGCAAAGTCAAGAGGATGTGGTGACCAATTCTGC	16	15	21	19	5	er	cooperative
seq1387_all_clean_seqs_gap0_no20_0.4	AAAACAACTCCAGGATGTGGTTTTACTCAGAATGTA	13	12	18	16	5	er	cooperative
seq1388_all_clean_seqs_gap0_no20_0.4	CAGATTTCCGGCTTCTGAGGAGCTGCCCTACCACAG	7	5	31	29	24	er	ambiguous
seq1389_all_clean_seqs_gap0_no20_0.4	AACACTACACATCCTCTCTTGTTGTGGCTGCTGAAC	12	10	25	23	13	er	independent
seq138_all_clean_seqs_gap0_no20_0.4	GCTAACGGAACCAGCACGCGGCCACCGCAGGAACCT	7	6	25	23	18	er	cooperative
seq1390_all_clean_seqs_gap0_no20_0.4	TTTTTTCCGCCTGTAGGGTCACATTGTGGTTGATTG	6	4	27	25	21	er	independent
seq1391_all_clean_seqs_gap0_no20_0.4	CTTAGCGGAAGAGGCGTGACCCAGGCGTACCGCAGG	7	6	30	28	23	er	cooperative
seq1392_all_clean_seqs_gap0_no20_0.4	TCCGGAAGTCGGAGGAACACCCCAGCCGCCGCAGCC	4	3	29	27	25	er	independent
seq1393_all_clean_seqs_gap0_no20_0.4	TGAAGTTCAGGGGGAAGTGGTTAGAGTCCCTGCGAG	13	12	18	16	5	er	cooperative
seq1394_all_clean_seqs_gap0_no20_0.4	GGCTGTGCTTCAGGATGTGGTAATGCTTGGGAGGCG	13	12	18	16	5	er	cooperative
seq1395_all_clean_seqs_gap0_no20_0.4	CTCTTTCACAAAGGAAATGGAAACCACAAAGAGGAC	13	12	24	22	11	er	cooperative
seq1396_all_clean_seqs_gap0_no20_0.4	CCACGCCCCCTCCTTCCGCTGCGGGAGATAGCCACT	15	13	22	20	7	er	independent
seq1397_all_clean_seqs_gap0_no20_0.4	TGGCAGCGGGTGCGGAAACCACAGGCCTCCAGGCTT	14	13	19	17	5	er	cooperative
seq1398_all_clean_seqs_gap0_no20_0.4	AGGGAACAGGAAATGCAAAAAACCACAAGGGACAAG	9	8	23	21	14	er	cooperative
seq1399_all_clean_seqs_gap0_no20_0.4	GACCAATGTAAACAAGGATGTGGGTTCTCCGGGCAC	16	15	21	19	5	er	cooperative
seq13_all_clean_seqs_gap0_no20_0.4	GAGGACTTCCGGGTGGGTGTGATATCTGCGGGCCCG	8	6	29	27	21	er	independent
seq1400_all_clean_seqs_gap0_no20_0.4	ATGTAAACAAGGATGTGAGTTCTGCGGCCACACTCT	11	10	25	23	14	er	cooperative
seq1401_all_clean_seqs_gap0_no20_0.4	GCGCTACAGGAACTTCCTGCGCGGTTGCTGTCGTTG	15	13	22	20	7	er	independent
seq1402_all_clean_seqs_gap0_no20_0.4	GCGCAAGGATCCGGTTTGTTGTGGTGTGGGGAGGGG	10	8	22	20	12	er	independent
seq1403_all_clean_seqs_gap0_no20_0.4	ACCAGAAGCACTGCAGGATGTGGTATCAAGACGCCT	16	15	21	19	5	er	cooperative
seq1404_all_clean_seqs_gap0_no20_0.4	TATTCAGGCTTCCGGGTGATGTTTGTGGCCACCCGG	11	9	26	24	15	er	independent
seq1405_all_clean_seqs_gap0_no20_0.4	CACTTCCTCTGTGACTGCAGGTTTCCAACCACAAGC	5	3	29	27	24	er	cooperative
seq1406_all_clean_seqs_gap0_no20_0.4	GCATCATCACTTCCTGTTGTGGGCAGTCGTTGCCTG	12	10	20	18	8	er	independent
seq1407_all_clean_seqs_gap0_no20_0.4	GGAGCAGGAAGCGTCGCCGGGGGGCCCACAAGGGTA	7	6	26	24	19	er	independent
seq1408_all_clean_seqs_gap0_no20_0.4	TTGTCACGTCCGGCACGCCGCGAACCGCAAGGAACC	9	7	25	23	16	er	cooperative
seq1409_all_clean_seqs_gap0_no20_0.4	TCCTATATACTTCCGTTTGCCTCGCGGTTTCTTTCT	12	10	25	23	13	er	cooperative
seq1410_all_clean_seqs_gap0_no20_0.4	GTTCTTCCACGTCCGCGTTACCCACAACGGCAGTGG	12	10	22	20	10	er	independent
seq1411_all_clean_seqs_gap0_no20_0.4	TCTTCTTCCTCCCCCACCCCAAAAGCCACAGGTGAC	7	5	26	24	19	er	independent
seq1412_all_clean_seqs_gap0_no20_0.4	CCCTCTCTTCTTCCTCCCCCACCACAAAAGTCACAG	12	10	22	20	10	er	independent
seq1413_all_clean_seqs_gap0_no20_0.4	CCCCCTGAACATCCGGGGCCTTTTAACCGCCCACGG	12	10	27	25	15	er	cooperative
seq1414_all_clean_seqs_gap0_no20_0.4	CTATATCACATCCTTTCTCTGACCGCGCTGACTTCG	11	9	23	21	12	er	independent
seq1415_all_clean_seqs_gap0_no20_0.4	GCGCGGACAGAGAAAGGATGTGGTATAGCAGAAAGT	16	15	21	19	5	er	cooperative
seq1416_all_clean_seqs_gap0_no20_0.4	GGCCGGCTTCCGGGGCGGGTGGAAAGGAGCCACAAG	9	7	30	28	21	er	independent
seq1417_all_clean_seqs_gap0_no20_0.4	CAGGCTCGCCACAGGGGAAGTGGTTAGGGCGGGTCC	16	15	21	19	5	er	cooperative
seq1418_all_clean_seqs_gap0_no20_0.4	CGACCGGAACCACTCTGAGGCGCTGCCGCAGACACC	6	5	26	24	20	er	independent
seq1419_all_clean_seqs_gap0_no20_0.4	AGGCCCGGATACCCGCCCCCAAAACCGCGTCCACAA	7	6	25	23	18	er	cooperative
seq1420_all_clean_seqs_gap0_no20_0.4	GTTGGGAGGCGCACATCCGGCGGTTACCCGGTGCTT	16	14	21	19	5	er	independent
seq1421_all_clean_seqs_gap0_no20_0.4	GTGCCTCACCGCTTCCGGCGCTGCGGGATGACGTCA	14	12	24	22	10	er	cooperative
seq1422_all_clean_seqs_gap0_no20_0.4	TAGGCTGAAGACTTCCGCCCCGCAGAGGACTTGCCT	14	12	20	18	6	er	independent
seq1423_all_clean_seqs_gap0_no20_0.4	GCGCCAGTCACCGTTTCCTGTGGTTTGCTGCCCGCC	16	14	21	19	5	er	cooperative
seq1424_all_clean_seqs_gap0_no20_0.4	TTATTTCCGGTGTTGATCTTTTTAGTGGTACCAGGC	6	4	26	24	20	er	independent
seq1426_all_clean_seqs_gap0_no20_0.4	CCTCTTGCTGCCTCTTCCTGTGGTCTTTTCTCTGTC	16	14	21	19	5	er	ambiguous
seq1427_all_clean_seqs_gap0_no20_0.4	CTCTGCTTCCTGTCTTTGAATGCCTCTGTGGTTTTC	8	6	29	27	21	er	cooperative
seq1428_all_clean_seqs_gap0_no20_0.4	TGGCCAGGAAGCCACTCGATTGCCGGCGCCCGCAGC	7	6	30	28	23	er	independent
seq1429_all_clean_seqs_gap0_no20_0.4	CTACAGGAAGTTCGAACTGGGCGGAGCCCACCGCAG	6	5	31	29	25	er	independent
seq1430_all_clean_seqs_gap0_no20_0.4	CCGGGACAGGAAGAGGCTGGGGACCGCGGCGAAGGT	9	8	24	22	15	er	independent
seq1431_all_clean_seqs_gap0_no20_0.4	CCACGGCTGGCTTCCTGTGTGGTTGGCACGCCTTAC	13	11	20	18	7	er	independent
seq1432_all_clean_seqs_gap0_no20_0.4	TGCTTTTCAGGTGCAGGAAGTGGTTTGCCTTTGCCC	16	15	21	19	5	er	independent
seq1433_all_clean_seqs_gap0_no20_0.4	TCACCTCATCACAGGAAACCGCGAGCACCTCCTCCT	14	13	19	17	5	er	independent
seq1434_all_clean_seqs_gap0_no20_0.4	CCACCCACTTCCTGCCCTAGCTAGTGTGGTATTTTT	10	8	27	25	17	er	cooperative
seq1435_all_clean_seqs_gap0_no20_0.4	GTTTTCAAGGCAGGAAGTGGCTGTGGTGGCACGGAG	13	12	24	22	11	er	cooperative
seq1436_all_clean_seqs_gap0_no20_0.4	GCGGCTGAGAACACAGGATGTGGCTTTTGGCAGATG	16	15	21	19	5	er	independent
seq1437_all_clean_seqs_gap0_no20_0.4	CATGACGAAGGGGAAGGATGTGGTTTGAGGGCAGCA	16	15	21	19	5	er	cooperative
seq1438_all_clean_seqs_gap0_no20_0.4	CTCCGATTGAGAACAGGAAGCCACAGGCCAATACAA	16	15	21	19	5	er	independent
seq1439_all_clean_seqs_gap0_no20_0.4	TTTAGACACCGCTTCCTGCCACAAGCCCAAGACTTA	14	12	19	17	5	er	independent
seq143_all_clean_seqs_gap0_no20_0.4	CCGGGCTGCGGAAGGCGGGAACTCTGCGGTTCGCGG	10	9	27	25	17	er	cooperative
seq333_all_clean_seqs_gap0_no20_0.4	CCGGGCTGCGGAAGGCGGGAACTCTGCGGTTCGCGG	10	9	27	25	17	er	cooperative
seq1440_all_clean_seqs_gap0_no20_0.4	GATCCCCCTCCTCCATCCTGTGGCTTCGGGTTGCCG	16	14	21	19	5	er	independent
seq1441_all_clean_seqs_gap0_no20_0.4	AGTGGATAGCACTTCCTTCTCTTACCACAGTTCCTT	14	12	25	23	11	er	cooperative
seq1442_all_clean_seqs_gap0_no20_0.4	GGCTTCCGGCGGGGTACCCTCCTCTGTGGGCGGGGC	5	3	27	25	22	er	independent
seq1443_all_clean_seqs_gap0_no20_0.4	TACCCCGCCGGAAGCCCCCTGCTCTGTGGGAACCGG	10	9	27	25	17	er	cooperative
seq1444_all_clean_seqs_gap0_no20_0.4	GAGAGAGGCAGGAAGTGTTGTGGTTATTGTTTGAGC	11	10	21	19	10	er	cooperative
seq1445_all_clean_seqs_gap0_no20_0.4	AGTCTAACCAACAAAGGATGTGGTAGGTAAAAGGTT	16	15	21	19	5	er	cooperative
seq1446_all_clean_seqs_gap0_no20_0.4	ATACCGGCGCATCCGGATTTTGAAGCCGCAGTGGAC	12	10	26	24	14	er	independent
seq1447_all_clean_seqs_gap0_no20_0.4	CTCACAGAAGAGGCAGGAAGTGGTTTGAGTTATCAT	16	15	21	19	5	er	cooperative
seq1448_all_clean_seqs_gap0_no20_0.4	CTCATTGACAGGAAGTCTAACCACAGGCTTAGGCCC	11	10	21	19	10	er	cooperative
seq1449_all_clean_seqs_gap0_no20_0.4	CACCCCCCCAGTGCAGGAAGTGGTTTTCGAGGGCAG	16	15	21	19	5	er	cooperative
seq1450_all_clean_seqs_gap0_no20_0.4	TGCAATCAGGAAGCCTGCCCCTCTAGAACCACAAAA	9	8	29	27	20	er	cooperative
seq1451_all_clean_seqs_gap0_no20_0.4	CTGCTGCCGCGAACAGGAAACCACTACAATCAGGAG	16	15	21	19	5	er	independent
seq1452_all_clean_seqs_gap0_no20_0.4	CTGGCAGGCCTCACTTCCTCACCACATGGCCCTCCC	16	14	22	20	6	er	independent
seq1453_all_clean_seqs_gap0_no20_0.4	ATGCCTTCTTCCAGAGGATGTGGTCGCTACTAGTGG	16	15	21	19	5	er	cooperative
seq1454_all_clean_seqs_gap0_no20_0.4	AGCAACAGGAAAGAACAGCCTGACCACAGCAGCCAC	8	7	24	22	16	er	cooperative
seq1455_all_clean_seqs_gap0_no20_0.4	CAGCTGACAGGAAGGAGAGAACCACAGACAGTGCGA	10	9	22	20	12	er	cooperative
seq1456_all_clean_seqs_gap0_no20_0.4	TCCCTAAGTCACATCCTGTGGGCAAAGGCCCTAGCA	14	12	19	17	5	er	independent
seq1457_all_clean_seqs_gap0_no20_0.4	GCAGAACCAGAAACAGGATGTGGGTTCCCCTTTAAG	16	15	21	19	5	er	cooperative
seq1458_all_clean_seqs_gap0_no20_0.4	TTTGAGCGGGCAGGATGTGGTGACAATGATACTGCA	13	12	18	16	5	er	cooperative
seq1459_all_clean_seqs_gap0_no20_0.4	CCTGCAGCAACAGGATGTGGTTTGAAAGGATGAAAG	13	12	18	16	5	er	cooperative
seq1460_all_clean_seqs_gap0_no20_0.4	GGAACAGGAAGCGGCAGAAATAGCAGCCACCGCGGC	7	6	30	28	23	er	independent
seq1461_all_clean_seqs_gap0_no20_0.4	CTCGTGCGTCACTTCCGCCCCGCAGACCCGCCCACT	14	12	20	18	6	er	independent
seq1462_all_clean_seqs_gap0_no20_0.4	CAGGCTGCTTCCGGCGCGCGGCAGAGCGGTCAGAGC	10	8	27	25	17	er	independent
seq1464_all_clean_seqs_gap0_no20_0.4	AGCCGGAGGCGGAAGGAGCAGCGCTACCGCAGCGTC	11	10	27	25	16	er	cooperative
seq1465_all_clean_seqs_gap0_no20_0.4	GCAGGGACCGGAAGTCCATGGCTCTGCCGCAACCCT	10	9	27	25	17	er	independent
seq1466_all_clean_seqs_gap0_no20_0.4	GAGCTGCTCCGGAAGGGTGGTGTGTGGTCAACCTTG	11	10	25	23	14	er	cooperative
seq1467_all_clean_seqs_gap0_no20_0.4	GCACTGTGGGAGGAAGTGGGTATGTGGTGAGCTCTT	12	11	25	23	13	er	cooperative
seq1468_all_clean_seqs_gap0_no20_0.4	GACCTGCCTTCCGGCCTCCGTCACATGACCGCACAG	10	8	29	27	19	er	cooperative
seq1469_all_clean_seqs_gap0_no20_0.4	CATAGACCGGATGCCTCGTCAACCACAGAAACCAAT	9	8	23	21	14	er	cooperative
seq146_all_clean_seqs_gap0_no20_0.4	ACGTACGGGATGTGGGAGGTTTGTTTTGACCACACC	8	7	30	28	22	er	ambiguous
seq1470_all_clean_seqs_gap0_no20_0.4	TTTTGCCCAACAGGATGTGGTTTCTAAAGCAGACGG	13	12	18	16	5	er	cooperative
seq1471_all_clean_seqs_gap0_no20_0.4	CGTTTGCCTATCTTCCTCCCCACAGAAGCACTCCAT	14	12	20	18	6	er	independent
seq1473_all_clean_seqs_gap0_no20_0.4	GCTCCCTGGACAGGATGTGGTGCCGAGTAAACAGCT	13	12	18	16	5	er	independent
seq1474_all_clean_seqs_gap0_no20_0.4	GCCGGGCACTTCCTGTGGAGGCCGCAGCGGGTGCGC	11	9	22	20	11	er	independent
seq1475_all_clean_seqs_gap0_no20_0.4	CTCACCCCTGGAGGATGTGGGTTTCCAGGCTGACAG	13	12	18	16	5	er	cooperative
seq1477_all_clean_seqs_gap0_no20_0.4	GCAGGACTTCCTGTGTTGTGCTAACCTCAAATTACA	9	7	25	23	16	er	cooperative
seq1478_all_clean_seqs_gap0_no20_0.4	TGTGCTTTGTAGTGAGGATGTGGGTGCCTGCCTCAC	16	15	21	19	5	er	independent
seq1479_all_clean_seqs_gap0_no20_0.4	CCGGGAGGGACGGAGGATGTGTGGTTCTGTCTCCTT	15	14	22	20	7	er	independent
seq1481_all_clean_seqs_gap0_no20_0.4	GCCCCCATGCTTCCTGTTGTGGGAGATGAAGTGTGG	12	10	20	18	8	er	independent
seq1482_all_clean_seqs_gap0_no20_0.4	ACACACTGACTTCCTGTTGTGGGAGATAAAGTGTGG	12	10	20	18	8	er	independent
seq1483_all_clean_seqs_gap0_no20_0.4	CCCTTCCGCGTGGGTTGCACCTGCTAACCACAGAGC	5	3	28	26	23	er	cooperative
seq1484_all_clean_seqs_gap0_no20_0.4	GCCACGCAGTTCCCTTCCTGCGGCGTCCTCCACACC	16	14	21	19	5	er	independent
seq1485_all_clean_seqs_gap0_no20_0.4	GCCACTTCCTGGAAAACAGTAATTACCACACGTCTC	7	5	26	24	19	er	independent
seq1486_all_clean_seqs_gap0_no20_0.4	AATCCCGGAAACGCGGATTCAGCGGAGCGCGGTGAC	7	6	30	28	23	er	independent
seq1487_all_clean_seqs_gap0_no20_0.4	GAGGCCGAAAGGAAGTTTGAGGTTAAGCACAAGATG	11	10	20	18	9	er	cooperative
seq1488_all_clean_seqs_gap0_no20_0.4	CCTGCTGCTTCCGCCCGGAGTTGTTGTGGGCTCCAG	10	8	27	25	17	er	independent
seq1489_all_clean_seqs_gap0_no20_0.4	AGCTTGCTTCCTGTCCCCAAAACCCACAGCACACGG	9	7	24	22	15	er	independent
seq148_all_clean_seqs_gap0_no20_0.4	CTTTGCTGCCGCCTTCCTGTGCGGGGCCGTGGCGGC	15	13	22	20	7	er	independent
seq1490_all_clean_seqs_gap0_no20_0.4	CAGATCTGAAAGGGAAGTGGTTTCAAGAGGGTTCTT	13	12	18	16	5	er	independent
seq1491_all_clean_seqs_gap0_no20_0.4	GGCTGCAGGAAGTGGGAAGGTGTGGCTTTGAGTCTC	8	7	23	21	15	er	independent
seq1492_all_clean_seqs_gap0_no20_0.4	GGTGGCCGCCGGAAGTGTGACCGCGGGAGGGGAGTG	11	10	21	19	10	er	cooperative
seq1493_all_clean_seqs_gap0_no20_0.4	CCGCCGACACACTTCCGGCGGCCACCACAGGGTATT	14	12	25	23	11	er	independent
seq1494_all_clean_seqs_gap0_no20_0.4	TGACACCAGCCCTGAGGATGTGGTTCATCCTCCCAC	16	15	21	19	5	er	independent
seq1495_all_clean_seqs_gap0_no20_0.4	GCCGCTGCCTCTTCCTGTGTGGTTTTTCAGGGCTTA	13	11	20	18	7	er	cooperative
seq1496_all_clean_seqs_gap0_no20_0.4	CTTAGAGTACCAGGATGTGGTTTGGCCTGGGGGTGG	13	12	18	16	5	er	cooperative
seq1497_all_clean_seqs_gap0_no20_0.4	CCTCCCGGCTTCCGTTCCTTGACCACCTCCTTCTCG	11	9	23	21	12	er	independent
seq1498_all_clean_seqs_gap0_no20_0.4	TTTCTGACTTCCTGTGTGCTTCAGAAACCTCAATGA	10	8	28	26	18	er	independent
seq1499_all_clean_seqs_gap0_no20_0.4	GAAAGGGTTCATCCAGGAAACCACAACCCAGTGCCG	16	15	21	19	5	er	cooperative
seq149_all_clean_seqs_gap0_no20_0.4	GCAGGCGGAGCTTGAGGAAACCGCAGATAAGTTTTT	16	15	21	19	5	er	cooperative
seq14_all_clean_seqs_gap0_no20_0.4	TGACTCACCTTCCTGTAGGTTGGTTTTCTGCATATC	11	9	21	19	10	er	independent
seq1500_all_clean_seqs_gap0_no20_0.4	TGGGACGAGTGGGCGGAAACAGCCGCAGGTCTCTCT	15	14	23	21	8	er	independent
seq1501_all_clean_seqs_gap0_no20_0.4	CTGCCCAGCCACTTCCTGCCCAACCACAGACTGACA	14	12	24	22	10	er	cooperative
seq1502_all_clean_seqs_gap0_no20_0.4	CAGCAGAGGCGCGGATGTGGTTAAACGAGTGCCGTC	13	12	18	16	5	er	cooperative
seq1503_all_clean_seqs_gap0_no20_0.4	GAAAAATGAAGTTTCCGCAGTAACCACAACACAGCC	14	12	24	22	10	er	cooperative
seq1504_all_clean_seqs_gap0_no20_0.4	GGCCTGTCACACACAGGAAGCGGTCACAGAAAAGCT	16	15	21	19	5	er	cooperative
seq1505_all_clean_seqs_gap0_no20_0.4	CAACTTCCGGGGCCGGTTGCCTGGCAACCGCAGGAG	6	4	28	26	22	er	cooperative
seq1506_all_clean_seqs_gap0_no20_0.4	GGCAACCGGCCCCGGAAGTTGCGGCAGGTGCGTCCA	14	13	22	20	8	er	independent
seq1507_all_clean_seqs_gap0_no20_0.4	GAGGTGCCGGAAGCCAGTAGGTGGTTTTGGGTGCTA	9	8	22	20	13	er	independent
seq1508_all_clean_seqs_gap0_no20_0.4	TGATGCACTTCCTGAGGGCCCGCATGTGGTAAACAC	10	8	27	25	17	er	cooperative
seq1509_all_clean_seqs_gap0_no20_0.4	ACACAGAGAGTGAGAGGAAGTGGTTTAGAGATGAGA	16	15	21	19	5	er	independent
seq150_all_clean_seqs_gap0_no20_0.4	TGAGGAATGTTTTCCTGGGGCTGTGGGGCCAGGGTG	13	11	24	22	11	er	independent
seq1510_all_clean_seqs_gap0_no20_0.4	CCTCAAAACCCGGAAACGCCTTGCGGGGCAGTGTGG	12	11	24	22	12	er	independent
seq1511_all_clean_seqs_gap0_no20_0.4	CCGGCAGGAAGTTAGCATGGGCGGACCACACGGGGG	7	6	26	24	19	er	independent
seq1512_all_clean_seqs_gap0_no20_0.4	AGGGACTTCCGGTGACCAGAGCACTAGCGCCGCAAA	8	6	30	28	22	er	independent
seq1513_all_clean_seqs_gap0_no20_0.4	TACCACTGAAAGGATGTGCGGGTAGAAATGAGCAAT	12	11	19	17	7	er	independent
seq1514_all_clean_seqs_gap0_no20_0.4	GAGGGTTGCTGGGGGGAAGTGTGGTAAATCTTTTCC	15	14	22	20	7	er	independent
seq1516_all_clean_seqs_gap0_no20_0.4	GCTGTAGGAAATGTTATTCGCCGCGGTCAGGACAGG	7	6	24	22	17	er	independent
seq1517_all_clean_seqs_gap0_no20_0.4	GGCGGAACTTGTGCGTACGCTGGAAAACCGCTGGGG	4	3	28	26	24	er	independent
seq1518_all_clean_seqs_gap0_no20_0.4	GAAACCTCACTCTGAGGATGTGGGTTCTGCCTTCTT	16	15	21	19	5	er	cooperative
seq1519_all_clean_seqs_gap0_no20_0.4	AGCTGAAGGGCAGGATGTGGTTTCAGCATTCGGTGA	13	12	18	16	5	er	cooperative
seq1520_all_clean_seqs_gap0_no20_0.4	CCGCCCTTCCGGCTGGCCCCGCTCAGTCACCCGCAG	8	6	31	29	23	er	independent
seq1521_all_clean_seqs_gap0_no20_0.4	AATTGAGACAGGAAATGTTGGTTTGTGGTCAGGCAC	11	10	26	24	15	er	cooperative
seq1522_all_clean_seqs_gap0_no20_0.4	AGTAGAGGAGGAAGTTAAATGTGGTTTTCTGGGTGG	10	9	22	20	12	er	cooperative
seq1523_all_clean_seqs_gap0_no20_0.4	TCCAGCTCCACAGGATGTGGTGAGTGAAGCAGCAAG	13	12	18	16	5	er	cooperative
seq1524_all_clean_seqs_gap0_no20_0.4	CTAAGAATCATCCTGTGTAACAACACCCACAGTTAG	11	9	27	25	16	er	independent
seq1525_all_clean_seqs_gap0_no20_0.4	GAAGTGAGGTCAGGATGTGGTGGGTGACCCCTGAAA	13	12	18	16	5	er	cooperative
seq1526_all_clean_seqs_gap0_no20_0.4	AGAAGCAGGCATGCAGGATGTGGTTAGTGCATGGTA	16	15	21	19	5	er	cooperative
seq1527_all_clean_seqs_gap0_no20_0.4	AACAGGAAGTGGTCTTAGAGATCATGCGGTTCAGAG	5	4	27	25	22	er	cooperative
seq152_all_clean_seqs_gap0_no20_0.4	ACATGAGGAAACTGAAGCATAGAGAGGGTGGTTAAC	7	6	29	27	22	er	independent
seq335_all_clean_seqs_gap0_no20_0.4	ACATGAGGAAACTGAAGCATAGAGAGGGTGGTTAAC	7	6	29	27	22	er	independent
seq1530_all_clean_seqs_gap0_no20_0.4	TCATTTCCTCTGGTGTTATTGTGTTGTGGTTTTAAG	6	4	27	25	21	er	cooperative
seq1531_all_clean_seqs_gap0_no20_0.4	ATACTGAGTCATTTCCTGTGGTGTTATTGTGTTGTA	14	12	19	17	5	er	independent
seq1533_all_clean_seqs_gap0_no20_0.4	GCCACCTCTTCCTGTGTTGCAAACCACAGGTCCACC	10	8	24	22	14	er	cooperative
seq1534_all_clean_seqs_gap0_no20_0.4	GCCGCCTCTTCCTGTGTTGCAAACCACAGGTCCACC	10	8	24	22	14	er	cooperative
seq1535_all_clean_seqs_gap0_no20_0.4	ATAGTCTCTTCCTGTGTTGCAAACCACAGGTCCACC	10	8	24	22	14	er	cooperative
seq1536_all_clean_seqs_gap0_no20_0.4	TGGATGGCGGCGGATACTGCCCATGCCGCAAGGCCG	12	11	26	24	14	er	independent
seq1537_all_clean_seqs_gap0_no20_0.4	TGGCGGCGGATACTGCCCATGGCGCGAGGCCGCAAG	8	7	30	28	22	er	independent
seq1538_all_clean_seqs_gap0_no20_0.4	GCCCAGGGCGGCCGGAAGTTTGCGGGGCGGGGCGGA	14	13	23	21	9	er	cooperative
seq1539_all_clean_seqs_gap0_no20_0.4	CCCCTCCCTGCTTCCTGTGTGGTGAGGGGTGATCAG	13	11	20	18	7	er	independent
seq153_all_clean_seqs_gap0_no20_0.4	CAGAGCAGAGAGGAAGTGGTGGTGGCCACAGTCCCA	12	11	26	24	14	er	cooperative
seq1540_all_clean_seqs_gap0_no20_0.4	CTCAGAGGCACCAAGGGAAGTGGTTAAAACAGAAAG	16	15	21	19	5	er	cooperative
seq1542_all_clean_seqs_gap0_no20_0.4	CAGATTCGTGTTTCCGTGCCCGCAGCTCCGTCAGCT	13	11	20	18	7	er	independent
seq1543_all_clean_seqs_gap0_no20_0.4	CTGGCTCCCCTTCCTGCTGTGGTGAGGGCTTCCCTC	12	10	20	18	8	er	ambiguous
seq1544_all_clean_seqs_gap0_no20_0.4	TGGAACAATGCTGCTTCCTGTGGGTGTCCCCCGGCC	16	14	21	19	5	er	independent
seq1546_all_clean_seqs_gap0_no20_0.4	ACACCCCAGGAAGTGGCAGAGACCACAACAAGTCAG	9	8	23	21	14	er	cooperative
seq1547_all_clean_seqs_gap0_no20_0.4	GTGGTCTCTGCCACTTCCTGTGGTGTAAACAGTCTC	16	14	21	19	5	er	cooperative
seq1548_all_clean_seqs_gap0_no20_0.4	ATGAACCACTTCCTGTGTGTTCCCACAGAGGTCAGG	11	9	23	21	12	er	cooperative
seq1549_all_clean_seqs_gap0_no20_0.4	AGGCCGTGCAGGAAATGAGACCCACAGCCACGTCAC	11	10	22	20	11	er	independent
seq1550_all_clean_seqs_gap0_no20_0.4	GAATGACAGAAGCGGAAACCACATGAAAAAGGTGTT	14	13	19	17	5	er	cooperative
seq1552_all_clean_seqs_gap0_no20_0.4	GCGATACGAGACTTCCTGCGGGCTCGTGACATCAGC	14	12	19	17	5	er	independent
seq1553_all_clean_seqs_gap0_no20_0.4	ACTGCACGGCTGGGAGGATGTGGTCACACACGCCAC	16	15	21	19	5	er	cooperative
seq1554_all_clean_seqs_gap0_no20_0.4	AGCGCCCCATCCCGCGGATGTGGTAAAGCTTCGCGC	16	15	21	19	5	er	cooperative
seq1555_all_clean_seqs_gap0_no20_0.4	TGCTCAGGATGTTTAAAAACAAAACCACGCGTCTAT	7	6	25	23	18	er	independent
seq1556_all_clean_seqs_gap0_no20_0.4	GGGTCCTTCCGGGTTTTGTGTCGAATCTGCGGCGGC	8	6	30	28	22	er	ambiguous
seq1557_all_clean_seqs_gap0_no20_0.4	TCAGGGGTGGGAGGAAGTGGTTAGGATCAGCCTGGG	13	12	18	16	5	er	cooperative
seq1558_all_clean_seqs_gap0_no20_0.4	CTGCAGATGCATTTCCTTTTTGTGGTAGCAAGCGTG	14	12	23	21	9	er	cooperative
seq1559_all_clean_seqs_gap0_no20_0.4	TGACAGACCCGGAAATAAGAGGAGACCACACACTTG	11	10	26	24	15	er	cooperative
seq155_all_clean_seqs_gap0_no20_0.4	CAGAGTAGAGGGGAAATGTGGGGTTGGAACTCCCAC	12	11	19	17	7	er	independent
seq1560_all_clean_seqs_gap0_no20_0.4	TGGTGGCTATTTCCTCTCCCGCTGTGGTCCCTGGAG	12	10	25	23	13	er	independent
seq1561_all_clean_seqs_gap0_no20_0.4	CCCACCCTCGCCGGAAGCCGAGCGGTTTCTACATCA	13	12	23	21	10	er	cooperative
seq1562_all_clean_seqs_gap0_no20_0.4	AGGACACAGACAGGAAACCCGCAGGCTTTGTTTTTT	13	12	19	17	6	er	cooperative
seq1563_all_clean_seqs_gap0_no20_0.4	AGGACCTAACACTCAGGAAGTGGTCAACCTTGCTGC	16	15	21	19	5	er	cooperative
seq1564_all_clean_seqs_gap0_no20_0.4	TTCTGGACATGCTTCCTGTGGCTTCTCTCCTGCGCT	14	12	19	17	5	er	independent
seq1566_all_clean_seqs_gap0_no20_0.4	TAAACCCTGCTTCCTGTCCCTGCGCCCCACAAGGAG	12	10	27	25	15	er	independent
seq1568_all_clean_seqs_gap0_no20_0.4	TGGCTTTGCAGAAGGAAGCTGTGGTTTCTGGTCTTC	14	13	22	20	8	er	cooperative
seq1569_all_clean_seqs_gap0_no20_0.4	TCTTTAAAACCCGGAAGTTCCTGTGGTTCATACGCT	13	12	24	22	11	er	cooperative
seq1570_all_clean_seqs_gap0_no20_0.4	GGTTTCCGGGTGAAAAAAAAAAAAAAAACCACGCCA	5	3	29	27	24	er	independent
seq1573_all_clean_seqs_gap0_no20_0.4	AACCTGCAGACTTCCTGCCATGTGACCACAGGGTCT	13	11	26	24	13	er	cooperative
seq1574_all_clean_seqs_gap0_no20_0.4	GAGCCACCGGAAACGGAGCTGCGGCCGCGCCCCGCC	9	8	22	20	13	er	independent
seq1575_all_clean_seqs_gap0_no20_0.4	CTTCTGGCGGAAGCGGCACAAGCCGCAGTACAGCGC	9	8	23	21	14	er	cooperative
seq1576_all_clean_seqs_gap0_no20_0.4	CTGCACTTCCGGTCAGGCGGTCGGGCTGCGGGGCCC	8	6	29	27	21	er	independent
seq1577_all_clean_seqs_gap0_no20_0.4	AATGAAGGAGGGGCAGGATGTGGTCTTGGTGAATCA	16	15	21	19	5	er	cooperative
seq1578_all_clean_seqs_gap0_no20_0.4	TAAAACACCAGGAAACTCTGTGGTGAGTGGGAGGTG	11	10	21	19	10	er	cooperative
seq1579_all_clean_seqs_gap0_no20_0.4	AAGGACCGACCCGTTTTCCGCCCGCAGCGGAGCTTG	17	15	22	20	5	er	independent
seq1580_all_clean_seqs_gap0_no20_0.4	GCCCACTTCCTGCCGTAAGAGAAAACCACTAACACA	8	6	26	24	18	er	cooperative
seq1581_all_clean_seqs_gap0_no20_0.4	AGTCCTGCCCACTTCCTGCCGCAAGAGAAATCCACT	14	12	19	17	5	er	independent
seq1582_all_clean_seqs_gap0_no20_0.4	AGGCCCACCTGCTGCGGATGTGGTCTCTGTGTGTGC	16	15	21	19	5	er	cooperative
seq1583_all_clean_seqs_gap0_no20_0.4	CCACTAGCAGGAAAACGGGCCGAGGGACCGCAAGCA	10	9	28	26	18	er	cooperative
seq1584_all_clean_seqs_gap0_no20_0.4	TGTTCAGGAACAGGAAATGAAACCCCGCAGCTTTGA	13	12	25	23	12	er	independent
seq1586_all_clean_seqs_gap0_no20_0.4	ACAGGAAATGTTAGAGGTTGAGTTAGCGGTTATGAG	4	3	27	25	23	er	cooperative
seq1587_all_clean_seqs_gap0_no20_0.4	ACCAGAACAGGAAATGTTAGTGGTTGAGTTAACGGT	10	9	21	19	11	er	independent
seq1588_all_clean_seqs_gap0_no20_0.4	GAAGAGGGTGGAGAAGGAAGTGGTCACACCACTTGC	16	15	21	19	5	er	independent
seq1589_all_clean_seqs_gap0_no20_0.4	AACCTAGAAAAGGAAGCTGCGGTTTTTCAGGGTATG	12	11	20	18	8	er	cooperative
seq158_all_clean_seqs_gap0_no20_0.4	TTGGAGGCGGAAACAGGCACCGAAAGCGGTGGAAGT	9	8	27	25	18	er	independent
seq1590_all_clean_seqs_gap0_no20_0.4	AGACGGTAGGCCAGGAAACCGCAGGCCCCTGCCGGG	14	13	19	17	5	er	cooperative
seq1592_all_clean_seqs_gap0_no20_0.4	ACACAGGAAGCAAAAGTTAAGCTATAAAACCCGCAA	6	5	31	29	25	er	independent
seq1594_all_clean_seqs_gap0_no20_0.4	GGAGCGCGCCGGAAACGCGCGGCTGCGGCCCGGGAG	11	10	26	24	15	er	independent
seq1595_all_clean_seqs_gap0_no20_0.4	TAACGCGAGAACTTCCTGCGGGCCACGCCCTCTTTC	14	12	19	17	5	er	independent
seq1596_all_clean_seqs_gap0_no20_0.4	TGTTGCACATGTTCAGGATGTGGTAGACAGCTTTCA	16	15	21	19	5	er	cooperative
seq1597_all_clean_seqs_gap0_no20_0.4	GAAAAAAATGAGCTTCCTTTAACCACAACTGTATTA	15	13	23	21	8	er	cooperative
seq1598_all_clean_seqs_gap0_no20_0.4	AATAAACAGGAAGGTCTCTTGGAGCTGTGGTCTTGG	9	8	28	26	19	er	cooperative
seq15_all_clean_seqs_gap0_no20_0.4	GTCACGCGCCGGATCCAACCCCCAACCACTTTAGCC	11	10	26	24	15	er	independent
seq1600_all_clean_seqs_gap0_no20_0.4	GAGGAAAAAGGAAACAGAAACTCCGCAACTTGCGCC	10	9	23	21	13	er	independent
seq1601_all_clean_seqs_gap0_no20_0.4	CCCTTGCCAGAGGAAGCCACTGCCACCGCAGAAGCA	12	11	26	24	14	er	cooperative
seq1602_all_clean_seqs_gap0_no20_0.4	CTTACAGTCACAACAGGATGTGGTTTGACATTTACT	16	15	21	19	5	er	cooperative
seq1603_all_clean_seqs_gap0_no20_0.4	GGCTTGCCAAGAGGAAATTTGAAGCCACAATAACAT	13	12	25	23	12	er	independent
seq1604_all_clean_seqs_gap0_no20_0.4	AGGCAGCACAGGAAGTTATAACCACATGTACACTTG	11	10	22	20	11	er	cooperative
seq1606_all_clean_seqs_gap0_no20_0.4	GCGGCTTTGTACGGAAACCCACACACATTGTTATTT	13	12	19	17	6	er	independent
seq1607_all_clean_seqs_gap0_no20_0.4	GCGGAGCGAGCGGCCGGATGCGGTCACCATAGAGAC	16	15	21	19	5	er	cooperative
seq1608_all_clean_seqs_gap0_no20_0.4	ATTAAAGACTTCCGTGCAAGACCACAGCTGCCTGAC	11	9	22	20	11	er	independent
seq1609_all_clean_seqs_gap0_no20_0.4	TTTACAGGAAATATCCAGAACAGGTAAACCCACAGA	7	6	30	28	23	er	cooperative
seq160_all_clean_seqs_gap0_no20_0.4	CTGCCGCTGCCTTCCGCCCCCACACACGCACACCAC	13	11	20	18	7	er	independent
seq1610_all_clean_seqs_gap0_no20_0.4	GGTCACATCCTTTCCCTTCTGTGTCTCAGCCGCAGT	8	6	30	28	22	er	independent
seq1611_all_clean_seqs_gap0_no20_0.4	GGCTCGGTGCTGCTTCCTGTGTGGTCAGGATCACAG	15	13	22	20	7	er	cooperative
seq1614_all_clean_seqs_gap0_no20_0.4	AACTGGGCGGAAAGAACGGCTAACCGCAAGCTGCCG	9	8	24	22	15	er	cooperative
seq1615_all_clean_seqs_gap0_no20_0.4	TACATAGGCGGAAGTGGCCTGCGGGCGCCGGAGTTG	10	9	22	20	12	er	cooperative
seq1616_all_clean_seqs_gap0_no20_0.4	GCAGTTTCAAGAGGATGTGGTCTCTTTCACTGCCTG	13	12	18	16	5	er	cooperative
seq1617_all_clean_seqs_gap0_no20_0.4	TCTCTTCCGTTCTCTGGTAGCTTTGTGGTAGCTTTG	6	4	26	24	20	er	cooperative
seq1618_all_clean_seqs_gap0_no20_0.4	TCGTGTTCTCTTCCGTTCTGTGGTAGCTTTTTGGTA	12	10	21	19	9	er	independent
seq1619_all_clean_seqs_gap0_no20_0.4	TGCAAAAAAACAGGAAACACCCAGCCGCAAATTATA	13	12	25	23	12	er	cooperative
seq161_all_clean_seqs_gap0_no20_0.4	GGCGGAAGCTGCCGCTGCCTTGCGCCCCCACACACG	4	3	28	26	24	er	independent
seq1621_all_clean_seqs_gap0_no20_0.4	GAAGGGAGGAAGCCTGAGAACTGTGGTCTCCTGAAG	8	7	24	22	16	er	independent
seq1623_all_clean_seqs_gap0_no20_0.4	CCCCGTTACGCCCATCCGGCTCCCGCATAGGGCGTC	15	13	23	21	8	er	independent
seq1625_all_clean_seqs_gap0_no20_0.4	AGCGCTTCAGCAATTTCCTTGTGGTAGAGAGGAATG	16	14	22	20	6	er	independent
seq1626_all_clean_seqs_gap0_no20_0.4	CTGACGCATTTCCGGCCTTTGCGGTTGATCGGTCAT	11	9	22	20	11	er	cooperative
seq1627_all_clean_seqs_gap0_no20_0.4	ACAGCTCACACAGGAAATACAAACCTCAAAAAGCAA	13	12	24	22	11	er	cooperative
seq1628_all_clean_seqs_gap0_no20_0.4	CTTTGCTGCAGGATGTTCTAACCACAAGCCCAGGAG	11	10	22	20	11	er	cooperative
seq1629_all_clean_seqs_gap0_no20_0.4	TGCAGCCGCCGCGTCCGGTCCAGCCGCAGGGCCATG	14	12	24	22	10	er	independent
seq1630_all_clean_seqs_gap0_no20_0.4	ATCTCAACTAGGAAATGTTTTTGTGACCACAAAGGG	11	10	27	25	16	er	cooperative
seq1631_all_clean_seqs_gap0_no20_0.4	AGGGGAGGAACCAGGAAGTTGTGGTAAACTGTAGCA	14	13	22	20	8	er	cooperative
seq1632_all_clean_seqs_gap0_no20_0.4	TAAGTGAATTTCCTGCCCGCCTCCGCCCACAGCGTA	11	9	27	25	16	er	independent
seq1633_all_clean_seqs_gap0_no20_0.4	TCAGAACCAGGAAACTGAAGGCGGTTACTCCACATA	10	9	22	20	12	er	independent
seq1634_all_clean_seqs_gap0_no20_0.4	GATCTGTGCTCAGGATGTGGTGAGAGAATAAGGAAG	13	12	18	16	5	er	cooperative
seq1635_all_clean_seqs_gap0_no20_0.4	ACCACCCACTTCCCGCGCAGTTCCAAACCGCGACCA	11	9	28	26	17	er	cooperative
seq1636_all_clean_seqs_gap0_no20_0.4	CCCTCAGCGGAAGTGGAAGCTGTGGTTTCCAAAGGC	9	8	23	21	14	er	cooperative
seq1638_all_clean_seqs_gap0_no20_0.4	GGGCGGGTGAGACCAGGATGTGGGTTCCCCCACCTT	16	15	21	19	5	er	ambiguous
seq1639_all_clean_seqs_gap0_no20_0.4	CGTAGCGAGGAGCGGAAAACGCGGTAACCAAGGCGG	14	13	22	20	8	er	cooperative
seq1640_all_clean_seqs_gap0_no20_0.4	AGCTGTTTGGTCACAGGATGTGGTTATTAGAATAGG	16	15	21	19	5	er	cooperative
seq1642_all_clean_seqs_gap0_no20_0.4	GTTGTCTTGCCCAAAGGAAGTGGTTACTAGACCAGA	16	15	21	19	5	er	cooperative
seq1644_all_clean_seqs_gap0_no20_0.4	TGACTTCCGGTCCGTAGTGGGGCCTGCGGTGGGAGT	6	4	27	25	21	er	cooperative
seq1645_all_clean_seqs_gap0_no20_0.4	CCATTTCCGCGCACGTCTGCAGATGCGGTAGTCGAT	6	4	26	24	20	er	independent
seq1646_all_clean_seqs_gap0_no20_0.4	ACAGAGCAGGAAGCAGCCCTCACCACAGATGAAGCA	9	8	23	21	14	er	cooperative
seq1647_all_clean_seqs_gap0_no20_0.4	GAGGGCTGCTTCCTGCTCTGTGGAGGCCGCAGCGGG	11	9	27	25	16	er	independent
seq1648_all_clean_seqs_gap0_no20_0.4	CCCAGGGCAGGAAGGGCCAAACCGCTACTGCCACTG	10	9	22	20	12	er	cooperative
seq164_all_clean_seqs_gap0_no20_0.4	CATTATTAACCTTCCGGCAAATCCCCACAGCCGCCA	13	11	25	23	12	er	independent
seq1650_all_clean_seqs_gap0_no20_0.4	GCACCGTACCCGGAACTGCTCCCTCCCGCAGGCGCA	12	11	26	24	14	er	independent
seq1651_all_clean_seqs_gap0_no20_0.4	TTCAGGAAATGCAAACGGCTGCAGAGACCGCAGAGG	5	4	28	26	23	er	cooperative
seq1652_all_clean_seqs_gap0_no20_0.4	GCCACTATTTCCTGCCTTCTGCGGCTGAGAGTCCCA	10	8	22	20	12	er	independent
seq1653_all_clean_seqs_gap0_no20_0.4	CGCCGAACTTCCGGCAGTAAATTCCGTGGTTTCCCT	10	8	27	25	17	er	cooperative
seq1655_all_clean_seqs_gap0_no20_0.4	TACAATTCGCACCGGAACTTGCGGCCCGGCTTCATT	14	13	22	20	8	er	independent
seq1658_all_clean_seqs_gap0_no20_0.4	TGAATCATGACAGAGGAAGTGTGGTTCTGTGATTAC	15	14	22	20	7	er	independent
seq1659_all_clean_seqs_gap0_no20_0.4	GCAGGAAGACTAACACAAAACCATCAAACCACTCTG	4	3	29	27	25	er	ambiguous
seq165_all_clean_seqs_gap0_no20_0.4	GGGGTCAGGAAATGGGTGTGCCGCGGGTAAGGCGCT	8	7	24	22	16	er	independent
seq1660_all_clean_seqs_gap0_no20_0.4	TTCTGTAGCTTAGGATGTGGGTTTCTTTGTTTCTGA	13	12	18	16	5	er	cooperative
seq1661_all_clean_seqs_gap0_no20_0.4	ACAAAGAAACCTACATCCTAAGCCACAGAATACAGC	16	14	23	21	7	er	independent
seq1662_all_clean_seqs_gap0_no20_0.4	CATGTGCTTCCGGCTTGATCTGTGGTTATTCTGGTT	9	7	23	21	14	er	cooperative
seq1663_all_clean_seqs_gap0_no20_0.4	GCCATCCGCAGGACTCCGCGTTCTCGCGGTAAGTGG	5	3	27	25	22	er	independent
seq1664_all_clean_seqs_gap0_no20_0.4	TGATCAGCAAAAGGAAGTGGTTAACATGGCCCAGAA	13	12	18	16	5	er	cooperative
seq1665_all_clean_seqs_gap0_no20_0.4	GAGCATAGCCTAGCAGGATGTGGTTAAATACATTTG	16	15	21	19	5	er	cooperative
seq1666_all_clean_seqs_gap0_no20_0.4	TTTCTCTTCCTGTTTCCACCCTGACCACAGCCAGCT	8	6	25	23	17	er	cooperative
seq1667_all_clean_seqs_gap0_no20_0.4	CAGGGTGGAAACAGGAAGAGAAACCACACTTAACCT	14	13	24	22	10	er	cooperative
seq1668_all_clean_seqs_gap0_no20_0.4	GGGGCGCTGCGCAGGAAGCCGCAGTCCCTCTGCGGA	14	13	19	17	5	er	independent
seq1669_all_clean_seqs_gap0_no20_0.4	CTTAGTGGGGCAGGATGTGGTCAGGGAAGCTGATCT	13	12	18	16	5	er	cooperative
seq166_all_clean_seqs_gap0_no20_0.4	GCTTCAGGCTTCCGGGGCGCACACTGCCGCAAAGGC	11	9	27	25	16	er	independent
seq1671_all_clean_seqs_gap0_no20_0.4	GCCGGAAGCCACGCAGGGCCACGTCTGCGGTTCTGA	4	3	28	26	24	er	cooperative
seq1672_all_clean_seqs_gap0_no20_0.4	TCCCCTGTCTTCCGGAGGCTGCGGCGCAGCGGCGCA	11	9	22	20	11	er	independent
seq1673_all_clean_seqs_gap0_no20_0.4	TGTCCACCTCTACGGAAGTGCGCCGCAGTCCGCCAG	14	13	23	21	9	er	independent
seq1674_all_clean_seqs_gap0_no20_0.4	GGGGGCGGAAGTTTCGGTGCATTGTGGGTTCTCCTG	7	6	25	23	18	er	cooperative
seq1675_all_clean_seqs_gap0_no20_0.4	CTTTCGGGGGCGGAAGTTGCGGTGCATTGTAGGTTC	12	11	20	18	8	er	cooperative
seq1676_all_clean_seqs_gap0_no20_0.4	AAGAACCTAGAGGATGTGTGGTTTTATGTGCAGGGT	12	11	19	17	7	er	cooperative
seq1677_all_clean_seqs_gap0_no20_0.4	CATGCGTCACCTTCCTGTGTGGTCAGCAGTGCTTGC	13	11	20	18	7	er	independent
seq1678_all_clean_seqs_gap0_no20_0.4	CATCAAAAACAGAGGAAGCCACAGCAAATTGCTGCC	14	13	19	17	5	er	ambiguous
seq1679_all_clean_seqs_gap0_no20_0.4	GCGGGCGGAAGTGCCGAGGTTGTACCGCGGCGCTGG	7	6	25	23	18	er	independent
seq1681_all_clean_seqs_gap0_no20_0.4	TACCAACAGGAATCTTTGGGGTCTAAACCGCAAACA	9	8	28	26	19	er	cooperative
seq1682_all_clean_seqs_gap0_no20_0.4	CCGCCTTTCCGGAGCGCGGGCGCGCGGTGGCGGGAG	8	6	25	23	17	er	independent
seq1685_all_clean_seqs_gap0_no20_0.4	ACCTCATCCTGCTGTTCTTGTGTGTGGTTGAGCAGT	7	5	25	23	18	er	independent
seq1686_all_clean_seqs_gap0_no20_0.4	GACACAAGAACAGCAGGATGTGGTCAGAGGCGTCGT	16	15	21	19	5	er	cooperative
seq1687_all_clean_seqs_gap0_no20_0.4	GCAGGACTCCAGGAAGCCCGCGCAGCCGCAAAAAGC	12	11	26	24	14	er	cooperative
seq1688_all_clean_seqs_gap0_no20_0.4	TACAACTTGCAACGGAAACCACTTCAGGTTCATTAC	14	13	19	17	5	er	independent
seq1689_all_clean_seqs_gap0_no20_0.4	TGCCCAGTACTTCCTCTTGTGGGGGAGCACAACTTG	12	10	20	18	8	er	ambiguous
seq168_all_clean_seqs_gap0_no20_0.4	CACCCAAGGATATGCTTTTTTTTGGCAAGCCACATC	8	7	30	28	22	er	independent
seq1690_all_clean_seqs_gap0_no20_0.4	TATTCATGACATCCTGTCGGGCTTGTGGGCTGCGTA	12	10	26	24	14	er	independent
seq1691_all_clean_seqs_gap0_no20_0.4	AGAACAAAACAGGAAATAGTGGTTTGCAAAAATATA	12	11	20	18	8	er	independent
seq1692_all_clean_seqs_gap0_no20_0.4	GAAACCGGAAGCGGCGGCTGTCCGCGGTGCCGGCTG	7	6	25	23	18	er	independent
seq1693_all_clean_seqs_gap0_no20_0.4	CAAACAGGTTCCGGCCGGACTACAGCGCCCACAATG	10	8	29	27	19	er	independent
seq1694_all_clean_seqs_gap0_no20_0.4	AGCCGTTTCCGGCGCTCTACCCCGCCGCAGGCCGAG	8	6	25	23	17	er	ambiguous
seq1695_all_clean_seqs_gap0_no20_0.4	GGAAAAGGAAGTGGCTTTGACTTGCGGGCAGGGAGA	7	6	25	23	18	er	cooperative
seq1696_all_clean_seqs_gap0_no20_0.4	CCATGCACAACAGGATGTGGTTAGACAGTCAAAATT	13	12	18	16	5	er	cooperative
seq1697_all_clean_seqs_gap0_no20_0.4	GGCAACCTGAGCTTCCGTGTAAAACCACAGTGTGAC	14	12	25	23	11	er	cooperative
seq1698_all_clean_seqs_gap0_no20_0.4	GCAGGAAACGCTTTCTTAACACTATGTGGGTGAGGT	4	3	27	25	23	er	independent
seq1699_all_clean_seqs_gap0_no20_0.4	AGCGTTTCCTGCCTGTCTGGGGCTGACAAACCACAA	7	5	31	29	24	er	independent
seq1700_all_clean_seqs_gap0_no20_0.4	GGTGTTAGTAGTCAAGGAAGTGGTCACCCTTGACAG	16	15	21	19	5	er	cooperative
seq1701_all_clean_seqs_gap0_no20_0.4	GACATATCCTGCATTCTCAGAAAAACCACAGGCTAG	7	5	26	24	19	er	cooperative
seq1702_all_clean_seqs_gap0_no20_0.4	TCTGAGAATGCAGGATATGTGTGTGGTCTCTAGTCA	13	12	24	22	11	er	independent
seq1703_all_clean_seqs_gap0_no20_0.4	TCTGGCTTCCTGTCTTAATAGGGCTTTGTGGTGTGC	8	6	29	27	21	er	cooperative
seq1704_all_clean_seqs_gap0_no20_0.4	AGAGCAACAGGATGCAAATAACCACAAGCAAGAATA	10	9	22	20	12	er	cooperative
seq1706_all_clean_seqs_gap0_no20_0.4	TGCATGCAACAGGAAGTGGGGTGTGGTTTGTTCTGG	12	11	24	22	12	er	cooperative
seq1707_all_clean_seqs_gap0_no20_0.4	GAGACACTCTGCTTCCTGCGGTGGAAGATTCAGTAT	14	12	19	17	5	er	independent
seq1708_all_clean_seqs_gap0_no20_0.4	GAAACTTCTCAAGGAAATAGCTGTGGTAAACAATAC	13	12	24	22	11	er	cooperative
seq1709_all_clean_seqs_gap0_no20_0.4	CTTGCTTGAGTCACAGGAAACCACTCAGAGGCTAAC	16	15	21	19	5	er	independent
seq1710_all_clean_seqs_gap0_no20_0.4	CAAGAGCCGGAAGTCCCTTGTGCCGCAGTCCTTCCC	9	8	23	21	14	er	independent
seq1711_all_clean_seqs_gap0_no20_0.4	TTTGCTGCAGAAGGATGTGGTTTATTCAGGTTTGAC	13	12	18	16	5	er	cooperative
seq1712_all_clean_seqs_gap0_no20_0.4	TTTCCTACAGAAGGATGTGGTTGGTGGGTTTGGTTT	13	12	18	16	5	er	cooperative
seq1713_all_clean_seqs_gap0_no20_0.4	GGGGCAGGAAGTGGAGGTTTGAAGTGGTTTAGAGTA	7	6	25	23	18	er	independent
seq1714_all_clean_seqs_gap0_no20_0.4	TCCCTTACCTTCCTGCTGCCACCAAACCACCAAACC	11	9	27	25	16	er	cooperative
seq1716_all_clean_seqs_gap0_no20_0.4	GGTCCGGATGTATAAAGCGCGGCCCCCTGCGGGGAG	6	5	30	28	24	er	independent
seq1717_all_clean_seqs_gap0_no20_0.4	AACAGGCAAAGGACAGGATGTGGTGAGCGTCGGCCC	16	15	21	19	5	er	cooperative
seq1718_all_clean_seqs_gap0_no20_0.4	GCTCATTTATGCATCCTGTGGTCTGTGTGTGTTTCG	14	12	19	17	5	er	independent
seq1719_all_clean_seqs_gap0_no20_0.4	AGAGGAAGTAAATTCTAACAGTGGAAACCACAGATT	4	3	28	26	24	er	cooperative
seq171_all_clean_seqs_gap0_no20_0.4	AGCTCCAGGAAGAGGGCCTGAAAACCAAACGGGGGA	8	7	25	23	17	er	independent
seq1722_all_clean_seqs_gap0_no20_0.4	ACTGGCTTCACTTCCTCCGCGGTTCCTCGGAGCCGC	13	11	20	18	7	er	independent
seq1723_all_clean_seqs_gap0_no20_0.4	CCCACTCCACTTCCGCCACCGCCGCAGCCGCCGCTG	12	10	22	20	10	er	independent
seq1725_all_clean_seqs_gap0_no20_0.4	AAGGCGGTACTTCCTCCAGCATTTGCCGCAAGTTAT	12	10	26	24	14	er	independent
seq1726_all_clean_seqs_gap0_no20_0.4	GGGACGGGGAGGGCAGGATGTGGTCGCTCTTCCCTC	16	15	21	19	5	er	cooperative
seq1727_all_clean_seqs_gap0_no20_0.4	TTCAACAGGATGTGGGAACTTGACTCTCGCCGCAAA	8	7	30	28	22	er	cooperative
seq1728_all_clean_seqs_gap0_no20_0.4	GCCCAGGGAAGCACTTCCTGCGGGGCGCGGTGCAGC	16	14	21	19	5	er	independent
seq1729_all_clean_seqs_gap0_no20_0.4	AGCGACAGCGGATGCTCTCTGGCCGCAACATTCTTT	10	9	23	21	13	er	cooperative
seq172_all_clean_seqs_gap0_no20_0.4	TGAGGGGCTCGCCGGGAAATGTGGTTTAGCGGCCCT	15	14	22	20	7	er	cooperative
seq1730_all_clean_seqs_gap0_no20_0.4	GTGCTAGGACACAGGAAGCGATACCACAAAGAACAT	14	13	24	22	10	er	cooperative
seq1731_all_clean_seqs_gap0_no20_0.4	GTGGCGAAAGTGCGGATGCGAAACCGCTGGCTCGGC	14	13	24	22	10	er	cooperative
seq1733_all_clean_seqs_gap0_no20_0.4	CGGGACTTCCTGTCTTCCCTGTTGCGGAGCTCTGAA	8	6	25	23	17	er	independent
seq1734_all_clean_seqs_gap0_no20_0.4	CTGCTGGCGTTCCCGGATGTGCGGTGGCGGTGCTAC	15	14	22	20	7	er	cooperative
seq1735_all_clean_seqs_gap0_no20_0.4	CCATCTTCATACAGGATGCTGTGGTATGTAAAACAA	14	13	22	20	8	er	cooperative
seq1736_all_clean_seqs_gap0_no20_0.4	CATACAGGATGCTGGGGTATGTAAAACAAACCACGG	7	6	31	29	24	er	independent
seq1737_all_clean_seqs_gap0_no20_0.4	TTTCACTTCCGGCATGTTTTTCACCCACAGGGATAT	8	6	25	23	17	er	independent
seq1738_all_clean_seqs_gap0_no20_0.4	ATAAACAGGAAGCTGAGTATGTGACCACAGACATTC	8	7	25	23	17	er	cooperative
seq1739_all_clean_seqs_gap0_no20_0.4	TGAGAGTAAAAAGGATGTGGTTTCCTTTCATTTTTT	13	12	18	16	5	er	cooperative
seq1740_all_clean_seqs_gap0_no20_0.4	GAAACAATTTCCTGTACCTCTGTGGTAAAAATGATA	10	8	23	21	13	er	independent
seq1741_all_clean_seqs_gap0_no20_0.4	CTTAGTGTTTGAGGATGTGGGTTTTACAATCAGATC	13	12	18	16	5	er	cooperative
seq1744_all_clean_seqs_gap0_no20_0.4	CGGTCAGGTCGCAGGAAACCACAGCGGCAGCGCGGC	14	13	19	17	5	er	ambiguous
seq1745_all_clean_seqs_gap0_no20_0.4	TGCAGCTTCCTGTCTGAGGCTTTGTGGTCCTTTCAT	8	6	25	23	17	er	ambiguous
seq1746_all_clean_seqs_gap0_no20_0.4	CGTTTCCTGTCTGGGACTGCGCCCACGCGGTCACGT	5	3	28	26	23	er	independent
seq1747_all_clean_seqs_gap0_no20_0.4	CCAACACAGGAAATAATTTGAAACCACAATCAGAAA	9	8	24	22	15	er	cooperative
seq1748_all_clean_seqs_gap0_no20_0.4	GACTATGTGCTTCCGGTCTCCAATACCGCAGGAGGG	12	10	26	24	14	er	cooperative
seq1750_all_clean_seqs_gap0_no20_0.4	GCTTGGGGCTCCTTCCTGCGGTGCTTCTCTCTTTCG	14	12	19	17	5	er	independent
seq1751_all_clean_seqs_gap0_no20_0.4	TAACTTGAACTTCCTTTTGACCACCTGTACGGTATA	12	10	21	19	9	er	independent
seq1752_all_clean_seqs_gap0_no20_0.4	GAGACAGGAAATGTAGACTTGAGTCCTGTGGTAAAC	7	6	29	27	22	er	cooperative
seq1753_all_clean_seqs_gap0_no20_0.4	AACCAAACAGCCACAGGAAGTGGTTTCTGTGATTCA	16	15	21	19	5	er	cooperative
seq1754_all_clean_seqs_gap0_no20_0.4	AGATGCAAACACAGGAAACTTGTGGTCTATGCTGCT	14	13	23	21	9	er	cooperative
seq1755_all_clean_seqs_gap0_no20_0.4	GGCCTTCTGCCTACATCCTGCGGCGCCCGCGACCCG	16	14	21	19	5	er	independent
seq1757_all_clean_seqs_gap0_no20_0.4	TGAAGTACTAGTCAAGGATGTGGTTTTACATAGCAG	16	15	21	19	5	er	cooperative
seq1758_all_clean_seqs_gap0_no20_0.4	GACCAGGAAACGGGGCGTGGCGGCCGCCGTGGTTAC	6	5	30	28	24	er	independent
seq1759_all_clean_seqs_gap0_no20_0.4	TGAGAAAGCTATTTCCGCCCACAAAGAGGCAAGTCT	14	12	19	17	5	er	ambiguous
seq175_all_clean_seqs_gap0_no20_0.4	GCTGCGCAGAGGAAACCAGGCTTGTTGGTTTTCATG	11	10	26	24	15	er	independent
seq1761_all_clean_seqs_gap0_no20_0.4	GCCCGCGGCTCCGGAAGCGGCTGCGGCCCCGACCGG	13	12	24	22	11	er	independent
seq1762_all_clean_seqs_gap0_no20_0.4	AAAGAGAAAGGAAACAAAGTATAGCACCACAGTGAG	10	9	27	25	17	er	independent
seq1763_all_clean_seqs_gap0_no20_0.4	TCTAAATCACTTCCTGTTACAGAAACCACAGGCCTG	12	10	26	24	14	er	cooperative
seq1764_all_clean_seqs_gap0_no20_0.4	TCTGTCGCACATCCGGTGTGAGCTGCGGGGCGGTGG	12	10	26	24	14	er	independent
seq1765_all_clean_seqs_gap0_no20_0.4	CAGCTCCGACTTCCGGGTGCGGTACGGCGAAGCAGA	12	10	20	18	8	er	independent
seq1766_all_clean_seqs_gap0_no20_0.4	AGCACCCGGAAGTCGGAGCTGCGCACGCACCGCGGG	8	7	30	28	22	er	independent
seq1767_all_clean_seqs_gap0_no20_0.4	TATTACTTCAGGAAGCCCAGGGGGAACCGCGCCCCG	11	10	27	25	16	er	independent
seq1769_all_clean_seqs_gap0_no20_0.4	TCCTCCATGCAGGAAAACCTCTGTGGTCTGGGAGCT	12	11	24	22	12	er	cooperative
seq1770_all_clean_seqs_gap0_no20_0.4	CTCAGCGGAAGAGCGGGCCTCTGGGCCGCAGTGACC	7	6	26	24	19	er	independent
seq1771_all_clean_seqs_gap0_no20_0.4	ACGTCTGTTTCCTGTGATTGAAACCGCAAGAAGAAG	10	8	24	22	14	er	cooperative
seq1772_all_clean_seqs_gap0_no20_0.4	TTCAATCACAGGAAACAGACGTCACCCACAGACCTA	11	10	26	24	15	er	independent
seq1773_all_clean_seqs_gap0_no20_0.4	CGCCTGCCCCACTTCCGCCCGGACCCGCAGCCCCTA	14	12	25	23	11	er	independent
seq1774_all_clean_seqs_gap0_no20_0.4	TTACAATCATTTCCTCTCTGTGGTTTGGTGACAAAT	12	10	21	19	9	er	cooperative
seq1775_all_clean_seqs_gap0_no20_0.4	ATTGTAAATTTCCTTTAAACGTCCCCACCGCGCTCC	11	9	28	26	17	er	independent
seq1776_all_clean_seqs_gap0_no20_0.4	TCCAGCCCCACCGGAAGTGGATGTGGTTAATCTAGT	13	12	24	22	11	er	cooperative
seq1777_all_clean_seqs_gap0_no20_0.4	CCTGTCCGGAAGTCCTGAGAGGGAATCGCCCGCAAA	8	7	30	28	22	er	ambiguous
seq1779_all_clean_seqs_gap0_no20_0.4	TCTGGATTTCCTGTGGGGCTCTCCCACAAGCAGTAC	9	7	24	22	15	er	independent
seq1780_all_clean_seqs_gap0_no20_0.4	TCTGTGAAAAAGGATGTGCGGTTATGGAGGAGAACT	12	11	19	17	7	er	cooperative
seq1781_all_clean_seqs_gap0_no20_0.4	CTGAAAAACCGGAAGTGGGTGGTTTGAAACGTAAAT	11	10	20	18	9	er	independent
seq1782_all_clean_seqs_gap0_no20_0.4	AGATTTTGTCTTCCTGTTGTGGCAACATCTGTAGAA	12	10	20	18	8	er	independent
seq1783_all_clean_seqs_gap0_no20_0.4	GTTTAACAGGAAACCCTGCAGACCACAGGTTCTGTC	9	8	23	21	14	er	cooperative
seq1784_all_clean_seqs_gap0_no20_0.4	ACCCAGTAGGGGCCAGGATGTGGTGAAAAGAGAATT	16	15	21	19	5	er	cooperative
seq1786_all_clean_seqs_gap0_no20_0.4	AGCCAGGAAATCCGCGCCTACACAGCCCAACCACAG	6	5	31	29	25	er	independent
seq1787_all_clean_seqs_gap0_no20_0.4	TTGTCTGCATCCTGTGCTGTGTGGTAGCTCTGGGTT	10	8	22	20	12	er	independent
seq1788_all_clean_seqs_gap0_no20_0.4	GGGGCTCCGCAGGAAGTAGGGCTCCCACAACTTTGC	12	11	25	23	13	er	independent
seq1789_all_clean_seqs_gap0_no20_0.4	AGCAACAACAAAGGAAGTGGCGGCCGCAGGGGGAGG	13	12	24	22	11	er	cooperative
seq178_all_clean_seqs_gap0_no20_0.4	TGGGATTCTCACTTCCGATCAGCGGTCCTGAACCCG	14	12	23	21	9	er	independent
seq1790_all_clean_seqs_gap0_no20_0.4	ACAGGAAGTGTCTCTATAGAAACCAAACCACAGAAA	4	3	28	26	24	er	cooperative
seq1791_all_clean_seqs_gap0_no20_0.4	AGCGGTGTTTCAGGATGTGAGGGCCCGCAGGAGCCG	13	12	25	23	12	er	independent
seq1792_all_clean_seqs_gap0_no20_0.4	AGCTGAGAGCCTGCCGGAAGCCACAGCTTCTTCTCG	16	15	21	19	5	er	independent
seq1794_all_clean_seqs_gap0_no20_0.4	GCCGCGAGTTCCGCCGGGTGGACCACAAATCCCGAG	10	8	23	21	13	er	independent
seq1795_all_clean_seqs_gap0_no20_0.4	TGGTCCACCCGGCGGAACTCGCGGTCCCGGCAGGCA	14	13	22	20	8	er	independent
seq1797_all_clean_seqs_gap0_no20_0.4	CCCCACATCCGGGGGCCGGGGCCGGGCTGTGGGCTT	8	6	30	28	22	er	independent
seq1799_all_clean_seqs_gap0_no20_0.4	AGGACGGGCGGAAGTGGCTGCGGTGGATGGTGGGAG	10	9	21	19	11	er	cooperative
seq179_all_clean_seqs_gap0_no20_0.4	CTCTCCACCTCCTTCCGACCAGGACCGCACCCCCCC	14	12	25	23	11	er	independent
seq17_all_clean_seqs_gap0_no20_0.4	GCTTCGTTTCCCGCCGGGGCTCACCGCGCCCCCCTA	9	7	24	22	15	er	independent
seq1800_all_clean_seqs_gap0_no20_0.4	GGCGCCTCTTTCCGCCCCCGCCCACAATCGAGCGCA	11	9	22	20	11	er	independent
seq1801_all_clean_seqs_gap0_no20_0.4	CGCCTACTCTACTTCCGCGGTCGGCCGGGTAAGGAC	14	12	18	16	4	er	ambiguous
seq1803_all_clean_seqs_gap0_no20_0.4	ATCACTTGTTTCCGCCAGCAAACCACAGGTCCCCAG	11	9	23	21	12	er	cooperative
seq1804_all_clean_seqs_gap0_no20_0.4	GTTAGCGTGATCGGAGGATGTGGTTTTCCTCCCTCT	16	15	21	19	5	er	cooperative
seq1805_all_clean_seqs_gap0_no20_0.4	TGCCACATCCTGCCCCTCCCCAGGTCTAACCACCAA	8	6	30	28	22	er	independent
seq1807_all_clean_seqs_gap0_no20_0.4	CTGCTGGGCCCCTTCCTGTCAGCGGTTGCTCTTTAC	14	12	23	21	9	er	independent
seq1808_all_clean_seqs_gap0_no20_0.4	TAGCCATCGTGCAAAGGATGTGGTGAAGTCAGTCAG	16	15	21	19	5	er	cooperative
seq1809_all_clean_seqs_gap0_no20_0.4	AGCCACATCCTCCCTTAGGTCTGACCGCAGCTTAAC	8	6	25	23	17	er	cooperative
seq180_all_clean_seqs_gap0_no20_0.4	ACAGGTTCAGGAAGCGGCCGTGGTTGTTAGTGGTGT	10	9	21	19	11	er	independent
seq337_all_clean_seqs_gap0_no20_0.4	ACAGGTTCAGGAAGCGGCCGTGGTTGTTAGTGGTGT	10	9	21	19	11	er	independent
seq1810_all_clean_seqs_gap0_no20_0.4	AGAGACAGCGGGCGGAAACCGCAGAAAAAGTTGAAA	14	13	19	17	5	er	cooperative
seq1811_all_clean_seqs_gap0_no20_0.4	CCCCCGGACGGTTACAGAGGACACTTAAGTGGTTTG	6	5	30	28	24	er	independent
seq1812_all_clean_seqs_gap0_no20_0.4	TGCCGTTTCCGGGTCACCCAGGCAGCTTGTGGCGGC	8	6	30	28	22	er	independent
seq1813_all_clean_seqs_gap0_no20_0.4	CAGATAAAGGCGCAGGAAGGAACCGCGGCGTGGCTG	15	14	23	21	8	er	independent
seq1814_all_clean_seqs_gap0_no20_0.4	GCAGGAAATGACGTCAGACCTCACTGCGGGTCTGAG	4	3	27	25	23	er	independent
seq1815_all_clean_seqs_gap0_no20_0.4	TTGCTCGGCTTCCTGGAGCTGTGGTCCGTGTGGGCT	11	9	22	20	11	er	independent
seq1816_all_clean_seqs_gap0_no20_0.4	AAGAGGAAGTCCCAAATTGCTTTTTAACCACCAACA	5	4	28	26	23	er	cooperative
seq1817_all_clean_seqs_gap0_no20_0.4	TGAAGGAGCGGAAGGGTTGCTTGCAGACCGCACGGT	10	9	28	26	18	er	cooperative
seq1818_all_clean_seqs_gap0_no20_0.4	AGGCCAGACGCCTTCCGTGGTTTACGGTGAGGGTGG	14	12	18	16	4	er	independent
seq1819_all_clean_seqs_gap0_no20_0.4	TGTGAACTGACAGGATGTGGTACAAGGCTTACAAAG	13	12	18	16	5	er	ambiguous
seq181_all_clean_seqs_gap0_no20_0.4	TGGGGTGGGGTGGGAAGTGCCAGCGGTCTGGGTGTC	13	12	24	22	11	er	independent
seq1820_all_clean_seqs_gap0_no20_0.4	TCCAGCGGAAGGGGGCATCTTTGCGGCAGAGGCAGC	7	6	24	22	17	er	independent
seq1821_all_clean_seqs_gap0_no20_0.4	AAGATGCCCCCTTCCGCTGGAAAGCGGTAATGCCCA	13	11	25	23	12	er	independent
seq1822_all_clean_seqs_gap0_no20_0.4	TATCTCCTATCTCCAGGAAGTGGTTAGCCCTAGGAG	16	15	21	19	5	er	cooperative
seq1824_all_clean_seqs_gap0_no20_0.4	TTGAGGGGAAGGGGAGGAAGTGGTCATTGGAACTTG	16	15	21	19	5	er	independent
seq1826_all_clean_seqs_gap0_no20_0.4	TGGCAGCCACATCCTGCCTGTGGCTAGGTCAACCCA	12	10	21	19	9	er	ambiguous
seq1827_all_clean_seqs_gap0_no20_0.4	GCTCCTCCCGGATATAAAGCCCCAAACCACGCCACT	10	9	27	25	17	er	independent
seq1829_all_clean_seqs_gap0_no20_0.4	GGTTCATTTCCTTTTCCTCCTTGTGGTATAAAAGAG	9	7	24	22	15	er	independent
seq182_all_clean_seqs_gap0_no20_0.4	CAGCTAGAGGAAGCGCTTCGCCCGCGAACCACAGGG	9	8	29	27	20	er	cooperative
seq1830_all_clean_seqs_gap0_no20_0.4	ACAAGGAGGAAAAGGAAATGAACCACGAATAGCAAA	14	13	23	21	9	er	independent
seq1831_all_clean_seqs_gap0_no20_0.4	ACGACGTCCCGGAAGTGCTGCGGCAATGTTGCTCTT	11	10	21	19	10	er	independent
seq1833_all_clean_seqs_gap0_no20_0.4	ATGCCTGTAGGAGGATGTGGTTTCTACACAACTCTG	13	12	18	16	5	er	cooperative
seq1834_all_clean_seqs_gap0_no20_0.4	AGTGTAAACACGGAAGTGGCCGCAGGGGTGGGGGAT	12	11	20	18	8	er	independent
seq1835_all_clean_seqs_gap0_no20_0.4	ACTTACTTCCCGACGTCACAGCCTCCGACACCACAG	8	6	31	29	23	er	independent
seq1836_all_clean_seqs_gap0_no20_0.4	CACCGCCGGAGTCCCGGATGTGGTTGCTAGGGCAGC	16	15	21	19	5	er	cooperative
seq1837_all_clean_seqs_gap0_no20_0.4	GGAGCGGCGGAAGGGAGCTTGCGGCGGGAGGCTGAA	9	8	22	20	13	er	independent
seq1838_all_clean_seqs_gap0_no20_0.4	CGCCGGATGCATAAAAGACTGGCTGCGGTGGCTCAG	5	4	26	24	21	er	cooperative
seq1839_all_clean_seqs_gap0_no20_0.4	CCGTACTTCCGCTTTACTCAGATTTTGGACCGCGGG	8	6	30	28	22	er	independent
seq1840_all_clean_seqs_gap0_no20_0.4	CAGTCTCCTTCCGCGTCACCTCTGTGACCGCTGTGC	10	8	28	26	18	er	independent
seq1841_all_clean_seqs_gap0_no20_0.4	CCTGCTGGAGGTTTCCTGTGGCTTGGGGCTCCGCCC	14	12	19	17	5	er	independent
seq1843_all_clean_seqs_gap0_no20_0.4	GCGCACTTCCGGGCTGGTGAACGCGGTGACGTCACC	8	6	24	22	16	er	independent
seq1844_all_clean_seqs_gap0_no20_0.4	GACCTGGGTTTCCTGTCTGTACATCGCGGTTCCTAC	11	9	27	25	16	er	independent
seq1845_all_clean_seqs_gap0_no20_0.4	CAGCCAGCCAGGAAGCAGGGGCTGCGGGGCTGACAG	11	10	25	23	14	er	independent
seq1846_all_clean_seqs_gap0_no20_0.4	GCCACAGCCGGAAGCAGGCTGACCACAAGTGCTAAG	10	9	23	21	13	er	cooperative
seq1847_all_clean_seqs_gap0_no20_0.4	TTGGTCAGCCTGCTTCCGGCTGTGGCTTCAGTTAGT	15	13	23	21	8	er	independent
seq1848_all_clean_seqs_gap0_no20_0.4	GGGGCGGCTTCCGGCGGCGTGACCTGACCGCAAGAG	10	8	28	26	18	er	cooperative
seq1849_all_clean_seqs_gap0_no20_0.4	GCACCACCGGAAGTAGGGCTCAACCACCGCTCATTT	9	8	24	22	15	er	cooperative
seq184_all_clean_seqs_gap0_no20_0.4	TTCTTAGCAGAGGAAGCTGTTTGCGGGGAAAAAGGG	12	11	24	22	12	er	cooperative
seq1850_all_clean_seqs_gap0_no20_0.4	TGAGCCCTACTTCCGGTGGTGCTGTGGTCTGCCCCT	12	10	25	23	13	er	independent
seq1851_all_clean_seqs_gap0_no20_0.4	CGCCGCTCAACTTCCGGCAACCACAGCTCTCTCTGA	13	11	21	19	8	er	independent
seq1852_all_clean_seqs_gap0_no20_0.4	ACAGGAAGTGAGGCTGTGAGGAGTTTGTGGTGTGTA	4	3	28	26	24	er	cooperative
seq1853_all_clean_seqs_gap0_no20_0.4	TGGCATTCTCCTTCCTGTCTCCTAACCACAGCCCAC	13	11	26	24	13	er	cooperative
seq1854_all_clean_seqs_gap0_no20_0.4	GTTGTGCTCTTTCCTGCTTCCCGCAGTTTTTTAGTT	12	10	21	19	9	er	independent
seq1855_all_clean_seqs_gap0_no20_0.4	GCTTGTCTTCCGGTTTCGTCGCCGCCGCAGGCGCAC	9	7	25	23	16	er	independent
seq1856_all_clean_seqs_gap0_no20_0.4	ATGACTTCGAGGAAGTCTTCAGAAACCACAGGCTGA	11	10	26	24	15	er	cooperative
seq1857_all_clean_seqs_gap0_no20_0.4	TTTGATTTCCTGTCTCCATGTTGTGGTCAAGATTGC	8	6	24	22	16	er	cooperative
seq1858_all_clean_seqs_gap0_no20_0.4	GACTTGGGGGAAGTGGCTTGGTTTGCGTGGTTTCTC	9	8	28	26	19	er	independent
seq1859_all_clean_seqs_gap0_no20_0.4	CTCTCACTTCCCGTGTGAGAAAAACCACAGAAAAGC	9	7	25	23	16	er	cooperative
seq1860_all_clean_seqs_gap0_no20_0.4	GAGTTCTAGACTACAGGATGTGGTTAGAAGAAAAGA	16	15	21	19	5	er	cooperative
seq1862_all_clean_seqs_gap0_no20_0.4	ACCCTCTTTCCGGTGGAAAGCTGCGGCCTCCCAGAG	9	7	24	22	15	er	independent
seq1863_all_clean_seqs_gap0_no20_0.4	ATGTCAGGAAGAGGCTCAGGGCTGTGGTTTCTCTGT	7	6	25	23	18	er	cooperative
seq1864_all_clean_seqs_gap0_no20_0.4	AGCAGGTATACCACTTCCTGTGGTTATCATTTGAGG	16	14	21	19	5	er	cooperative
seq1865_all_clean_seqs_gap0_no20_0.4	TCACATCCTGTAATGGTTTGCGCATACCACAGTTCT	6	4	27	25	21	er	independent
seq1866_all_clean_seqs_gap0_no20_0.4	AACCATTACAGGATGTGAGATTCAAACCACTAACAG	11	10	27	25	16	er	cooperative
seq1867_all_clean_seqs_gap0_no20_0.4	CCTTGCAGCAACGGATGTGGGTTTTTTTTTTTCTTT	13	12	18	16	5	er	cooperative
seq1868_all_clean_seqs_gap0_no20_0.4	ACTCCAGAGGAAGTGGCAAGACGAGCGCGGTAACGG	9	8	28	26	19	er	independent
seq1869_all_clean_seqs_gap0_no20_0.4	CAGGCCTTTCCTGCTATCGTTTGTGGTTTGAGCAGT	9	7	24	22	15	er	cooperative
seq186_all_clean_seqs_gap0_no20_0.4	GGGCAGGAAGGAAGAGGGCTCCTCCCCACAAGCTCT	6	5	26	24	20	er	independent
seq1870_all_clean_seqs_gap0_no20_0.4	CAAACGATAGCAGGAAAGGCCTGTGGCTTGACAGCA	13	12	24	22	11	er	independent
seq1872_all_clean_seqs_gap0_no20_0.4	GCGAGGAGACAACTTCCTTTTGTGGTCTGACCCTGG	15	13	23	21	8	er	cooperative
seq1873_all_clean_seqs_gap0_no20_0.4	CATTGATCAAAGACAGGATGTGGTAACAGGCAGTTA	16	15	21	19	5	er	cooperative
seq1874_all_clean_seqs_gap0_no20_0.4	CGGGCTGGGAGGAAGTGATGGCTGACCACAGAGGAG	11	10	26	24	15	er	cooperative
seq1875_all_clean_seqs_gap0_no20_0.4	TACCACCTCAGGATGTCTGAACCACATGCAAGCAGG	11	10	22	20	11	er	ambiguous
seq1876_all_clean_seqs_gap0_no20_0.4	AGCAGGAAGTATGTTGAAAGTCATAACCACAGCAAA	5	4	27	25	22	er	cooperative
seq1879_all_clean_seqs_gap0_no20_0.4	GGATGGCGGAAGAGGCGGCTGAGGCCGCAGGACGTG	8	7	25	23	17	er	independent
seq187_all_clean_seqs_gap0_no20_0.4	CCCTTCCTGCCCCCATGGCTCCCCTGAGGTTTTTCG	5	3	27	25	22	er	independent
seq1880_all_clean_seqs_gap0_no20_0.4	GACACCTGAGAGGATGTGTGGCTTTGTGCTATGAGA	12	11	19	17	7	er	independent
seq1881_all_clean_seqs_gap0_no20_0.4	GCTCCGCTTCCGGGAGGCGGGGCTTCTGCGGGTTCC	9	7	29	27	20	er	cooperative
seq1882_all_clean_seqs_gap0_no20_0.4	CAAATGAATAAAGGATGTGGTAAATTATTTTCTTCT	13	12	18	16	5	er	cooperative
seq1883_all_clean_seqs_gap0_no20_0.4	CTACCCTCCCTCTTCCTGTGGTTTCTCAAACATGTC	14	12	19	17	5	er	cooperative
seq1884_all_clean_seqs_gap0_no20_0.4	TTAAACACGGAAGTGCATCGGTTGTTGTGGTTATTC	9	8	28	26	19	er	cooperative
seq1885_all_clean_seqs_gap0_no20_0.4	GCTGCAAGGCGGAAGCAGCGCGGTCGGACGGGCATG	11	10	21	19	10	er	independent
seq1886_all_clean_seqs_gap0_no20_0.4	AACTTCCTCCGCGCGGGGCCACTGCTACCACAAAGG	5	3	28	26	23	er	cooperative
seq1888_all_clean_seqs_gap0_no20_0.4	CTCACACCCCACCCCGGACGGCCACAACGACGGCGA	16	15	22	20	6	er	independent
seq1889_all_clean_seqs_gap0_no20_0.4	ACCTGTGTTCTGGCAGGATGTGGTTGACCTCAGCAG	16	15	21	19	5	er	cooperative
seq188_all_clean_seqs_gap0_no20_0.4	CTCCCCCAGCACATCCTCTGCCACCGCTGCCTTTCC	14	12	24	22	10	er	independent
seq1890_all_clean_seqs_gap0_no20_0.4	GCTGCTGTAGTCGCTTCCTGCGGCCAGCCCGGGTTC	16	14	21	19	5	er	independent
seq1891_all_clean_seqs_gap0_no20_0.4	GTGGGGCAGGATGTGCTTGCCTGGCTGCGGTTGGAC	9	8	28	26	19	er	cooperative
seq1892_all_clean_seqs_gap0_no20_0.4	CCTAGAACCGGAAGAGAAAGGGGCTGCGGTGCAGCA	10	9	27	25	17	er	cooperative
seq1893_all_clean_seqs_gap0_no20_0.4	AGGAGTGTCACTTCCTCTTTCCTCACCACAGCCTCC	13	11	26	24	13	er	independent
seq1894_all_clean_seqs_gap0_no20_0.4	GGGCAGCATCCTGTGCCTGCTTCTCTTACCCACATC	9	7	30	28	21	er	independent
seq1895_all_clean_seqs_gap0_no20_0.4	TGAATATTCTTCCGCACGTACCCACATGGCTCACTT	11	9	22	20	11	er	independent
seq1896_all_clean_seqs_gap0_no20_0.4	AACATCCTGTGTAAAGAGAATTGAATGTGGTTTTCT	5	3	28	26	23	er	cooperative
seq1898_all_clean_seqs_gap0_no20_0.4	CACTTCCCGTGGGAGGATCTTGGGCTGCGGCTAGGG	5	3	28	26	23	er	cooperative
seq1899_all_clean_seqs_gap0_no20_0.4	TCCTCCCACGGGAAGTGCCGTAGGACCGCAGCCCGA	11	10	26	24	15	er	ambiguous
seq18_all_clean_seqs_gap0_no20_0.4	CTCCCAGCCGGGCGGAACCGAGACCGCTTCGTCCCC	14	13	24	22	10	er	independent
seq1900_all_clean_seqs_gap0_no20_0.4	TCCAAGGCGGAAAAAACCCGCCCTAAACCGCACCCC	9	8	28	26	19	er	cooperative
seq1901_all_clean_seqs_gap0_no20_0.4	CTCCTTCCTGTGTGTTACTCTTAAAAACCACAGAGG	6	4	28	26	22	er	cooperative
seq1902_all_clean_seqs_gap0_no20_0.4	TAGCATGTGAGCTTCCTGTGGGTTTGTGCAGCCCCA	14	12	19	17	5	er	ambiguous
seq1903_all_clean_seqs_gap0_no20_0.4	ACTCCTCCCGCTTCCGCTGCCGCAGCCGGTCGTAAC	13	11	20	18	7	er	independent
seq1904_all_clean_seqs_gap0_no20_0.4	AGACGGGACCGGAAGCCGGGCCGCAGGCGGCCGGGC	11	10	21	19	10	er	independent
seq1905_all_clean_seqs_gap0_no20_0.4	GAACTTCCGGGACCACGTGACGTAGAACCACAACAA	6	4	28	26	22	er	cooperative
seq1906_all_clean_seqs_gap0_no20_0.4	CCCAATTTCCTTTGCTCTGCTGTCTGCCAACCGCAA	8	6	31	29	23	er	ambiguous
seq1907_all_clean_seqs_gap0_no20_0.4	GATGCTTGTTCAGGATGCGGTTTCTTGCAGCAAGTT	13	12	18	16	5	er	cooperative
seq1908_all_clean_seqs_gap0_no20_0.4	AACACCACTTCCTACTGTGAAACCACACTGTATTTG	10	8	23	21	13	er	ambiguous
seq1909_all_clean_seqs_gap0_no20_0.4	AAACTACTTCCCCATATCATCTGTGGCTTGCACAAC	9	7	24	22	15	er	independent
seq1910_all_clean_seqs_gap0_no20_0.4	TTTCGAGAAAACCGGAAGTGCGTGGTCACGCCCCGC	14	13	23	21	9	er	cooperative
seq1911_all_clean_seqs_gap0_no20_0.4	GAGGAGATTTCCGGCCCCCATCCCCGCAGCGACCTT	10	8	24	22	14	er	independent
seq1912_all_clean_seqs_gap0_no20_0.4	GCACGCGCCGGGCGGAACCCACAGGCCTGGAAGCGA	14	13	19	17	5	er	independent
seq1913_all_clean_seqs_gap0_no20_0.4	TGTATGAAAAAAACAGGAAACCACAGAGAACTGAGG	16	15	21	19	5	er	cooperative
seq1914_all_clean_seqs_gap0_no20_0.4	CTGACACTTCCGGGAGCCTTGTAGCCACAGGAATCA	9	7	25	23	16	er	ambiguous
seq1915_all_clean_seqs_gap0_no20_0.4	AGTTGTGTTTTAGGATGTGGTCAAAGCCCAACAGAG	13	12	18	16	5	er	cooperative
seq1916_all_clean_seqs_gap0_no20_0.4	ACCTTCCTTCCTGCCTCCCTTGTGGCTCCAGTCCAC	9	7	23	21	14	er	independent
seq1917_all_clean_seqs_gap0_no20_0.4	TCATTCTCTGATAAAGGAAGTGGTTACAGCACAATT	16	15	21	19	5	er	cooperative
seq1918_all_clean_seqs_gap0_no20_0.4	AAAGTTGTATAGTGAGGATGTGGTCAAGAACTCACC	16	15	21	19	5	er	cooperative
seq1919_all_clean_seqs_gap0_no20_0.4	ATTCTGCATCCTGTGCTCTTTCCATGAGACCACAAA	9	7	30	28	21	er	ambiguous
seq191_all_clean_seqs_gap0_no20_0.4	ACTGCTTGATTTTCAGGAAGTGGTAAAGTGGCAGGT	16	15	21	19	5	er	cooperative
seq1920_all_clean_seqs_gap0_no20_0.4	ACGTAGACAGGAAAGTAATGTGGTTCAGGACTGAGT	10	9	21	19	11	er	independent
seq1921_all_clean_seqs_gap0_no20_0.4	AGGGTTACAATTTCCGTAAACCACAGAAGCAGCAGA	13	11	21	19	8	er	cooperative
seq1922_all_clean_seqs_gap0_no20_0.4	CGGTTCCGGCGCCTGAAGTTTTAGCTGCGGTGGCGG	5	3	28	26	23	er	cooperative
seq1923_all_clean_seqs_gap0_no20_0.4	GAGCAGCGGGAGGAAGCTGCGGCGCGCAGAGCAGAG	12	11	20	18	8	er	independent
seq1926_all_clean_seqs_gap0_no20_0.4	ACACTGGCCGGAAGGGGCGGGACCGCGAGTTAAGAG	10	9	23	21	13	er	cooperative
seq1927_all_clean_seqs_gap0_no20_0.4	GATTTGTCACAGGAAGTACCCACAGGCCAAGAAGTG	12	11	20	18	8	er	independent
seq1928_all_clean_seqs_gap0_no20_0.4	TGGGTACTTCCTGTGACAAATCGAGTTGACCACATG	9	7	30	28	21	er	cooperative
seq1929_all_clean_seqs_gap0_no20_0.4	CTGGAGAGGATGTGGCCCCAGTGTGGTTCTGTAACT	8	7	24	22	16	er	independent
seq192_all_clean_seqs_gap0_no20_0.4	GATGACTTCCTCAGTTCAGGGCTATGTGCGGGGGAG	8	6	29	27	21	er	independent
seq1930_all_clean_seqs_gap0_no20_0.4	AGTTTCTCAGCTTCCTGTGTGGTTTTCTTGATCTGC	13	11	20	18	7	er	cooperative
seq1931_all_clean_seqs_gap0_no20_0.4	GCCTGCGCTCTTTCCGGTAGCCACAGCCTCGTCTAA	13	11	21	19	8	er	independent
seq1932_all_clean_seqs_gap0_no20_0.4	GGGCTTCCGGCTGAACCCATGGCTGCGGGCTGTGCT	6	4	26	24	20	er	independent
seq1933_all_clean_seqs_gap0_no20_0.4	CACCGGAAAAGGCAAGCGCGGCCGCGCGGTTGGCGC	5	4	27	25	22	er	cooperative
seq1934_all_clean_seqs_gap0_no20_0.4	CCTGCCTGAGGCAGGAAGCCGCAGCTGAGGGACGGC	14	13	19	17	5	er	independent
seq1935_all_clean_seqs_gap0_no20_0.4	TTTCCTCGGATTCCCGGATGTGGGTGAGTTCATTTG	16	15	21	19	5	er	ambiguous
seq1937_all_clean_seqs_gap0_no20_0.4	CATTCAGTAAAAGGATGTGGTTTAGAACAGATGAAA	13	12	18	16	5	er	cooperative
seq1938_all_clean_seqs_gap0_no20_0.4	GCTCAAGTACCGGAAAGGCCCGCAGAAAGAAGGGCA	12	11	20	18	8	er	independent
seq1939_all_clean_seqs_gap0_no20_0.4	GCGCTTCCTGCCAGCTTGGAGGATAACCGCCTACCG	6	4	27	25	21	er	independent
seq1940_all_clean_seqs_gap0_no20_0.4	CAAGCTGGCAGGAAGCGCGGTGCAACCACAAGAGTC	11	10	26	24	15	er	cooperative
seq1943_all_clean_seqs_gap0_no20_0.4	GCGGGCAGGATCTTCCTGTGGTTTGCCTTGCCCACT	14	12	19	17	5	er	cooperative
seq1944_all_clean_seqs_gap0_no20_0.4	AGGCAAACTACAGGAAGATCCTGCCCGCAACTTGGT	13	12	25	23	12	er	cooperative
seq1945_all_clean_seqs_gap0_no20_0.4	GTAAGTAGGCCAGGAAGTGGTCACTGCAGCATGTGA	13	12	18	16	5	er	cooperative
seq1947_all_clean_seqs_gap0_no20_0.4	AAATATAGTGCTAAAGGAAGTGGTTTTCATGCAACT	16	15	21	19	5	er	cooperative
seq1948_all_clean_seqs_gap0_no20_0.4	CTCGGCGCGACGGATATTCCCGTGACCGCCGGGTTC	12	11	26	24	14	er	ambiguous
seq1949_all_clean_seqs_gap0_no20_0.4	GAGCGGAAACCCGAGAGTCAGTTCAACCACAGCCAC	5	4	27	25	22	er	cooperative
seq194_all_clean_seqs_gap0_no20_0.4	GAGCAGTGGTGGGAAATGTGGGGTTGGGGGTAAAGG	12	11	19	17	7	er	ambiguous
seq1950_all_clean_seqs_gap0_no20_0.4	AAGAGGAAATAAATACCAGAGTGAACCCACAAACCT	5	4	27	25	22	er	cooperative
seq1951_all_clean_seqs_gap0_no20_0.4	GTATTTATTTCCTCTTCGAAGAAATGCGGGGGTGCC	10	8	27	25	17	er	independent
seq1952_all_clean_seqs_gap0_no20_0.4	GGATGAACAGGAAGCTAAAGTAAATACCACAGTGAC	10	9	27	25	17	er	cooperative
seq1954_all_clean_seqs_gap0_no20_0.4	AGGAGAGGATGTTGCTTGAAGGTGTGGTCTCCTCCA	7	6	25	23	18	er	independent
seq1955_all_clean_seqs_gap0_no20_0.4	ACTGCCGTAAGGAAGCTGCCACCGCACGCAGTAGGG	11	10	22	20	11	er	independent
seq1957_all_clean_seqs_gap0_no20_0.4	AGGCTGTGGCGGAAGTGGTCGCGTTACCGCTTGTTT	11	10	27	25	16	er	cooperative
seq1959_all_clean_seqs_gap0_no20_0.4	GAGGAGGAAAGCGGAAGCGCTGCCCGCAGTGGTAGG	13	12	24	22	11	er	cooperative
seq1960_all_clean_seqs_gap0_no20_0.4	CCAGGAAGTTCAAACTGGGTGGAGCCCACCGCAGCT	4	3	29	27	25	er	ambiguous
seq1961_all_clean_seqs_gap0_no20_0.4	CACCCAGTTTGAACTTCCTGGCGGTTTTGTTTACAC	16	14	22	20	6	er	ambiguous
seq1962_all_clean_seqs_gap0_no20_0.4	CCGCCGCGCGCCGGATGCTAAGACCGCGATTTCCCC	13	12	24	22	11	er	cooperative
seq1963_all_clean_seqs_gap0_no20_0.4	GCCCAGGAAGTGGGTACAAAATGAGCCACAAGACCT	6	5	26	24	20	er	cooperative
seq1964_all_clean_seqs_gap0_no20_0.4	CTTGTGCCTACATCCTGTAGCTGTGGTTTAGGGACG	13	11	24	22	11	er	cooperative
seq1967_all_clean_seqs_gap0_no20_0.4	TGCCACCTGCTTCCTGCCTGTGTAGCCACAAGGGAC	12	10	26	24	14	er	independent
seq1969_all_clean_seqs_gap0_no20_0.4	GGCGGGGCATCCGGCAGCACCGCCTGCGGGCGCCCG	10	8	27	25	17	er	independent
seq1972_all_clean_seqs_gap0_no20_0.4	AGCGTCTATTTCCTCCGACTGCGGCGCGGCTGATAC	11	9	22	20	11	er	independent
seq1974_all_clean_seqs_gap0_no20_0.4	AACAGTCACATCCGGGGCCGAGAGGAACCGCGAACG	11	9	28	26	17	er	cooperative
seq1975_all_clean_seqs_gap0_no20_0.4	GTTCTCCTTCCTGTGCCGAGTGTGGTTTGCTATCAA	9	7	23	21	14	er	independent
seq1976_all_clean_seqs_gap0_no20_0.4	GCGCCGGTGACGGAAGTGCGGTGTTGAGCGCCGGCG	12	11	19	17	7	er	independent
seq1977_all_clean_seqs_gap0_no20_0.4	CCTCTTGGTTTCCTGTCCCTCACCACAAGAAGCAGT	11	9	23	21	12	er	cooperative
seq1978_all_clean_seqs_gap0_no20_0.4	GGCAGCCGGCTTCCGGCTGTGGGTGGTGCGGGGGAC	12	10	20	18	8	er	independent
seq1979_all_clean_seqs_gap0_no20_0.4	GTTGAGTAGTGACAGGAAGTGACCGCAAGGGGGCGC	15	14	23	21	8	er	cooperative
seq197_all_clean_seqs_gap0_no20_0.4	GGATGAGCTTCCCCATTCCGGCCGCAGCCGACCTAG	17	15	22	20	5	er	independent
seq1980_all_clean_seqs_gap0_no20_0.4	AAAGCAAACAGGAAGTGCTGTGGTAACAAGGCCCCA	11	10	21	19	10	er	cooperative
seq1981_all_clean_seqs_gap0_no20_0.4	GGCCGGAAGCGCTCTCGTTGGCCCTGCGGCGCTGGA	5	4	27	25	22	er	independent
seq1982_all_clean_seqs_gap0_no20_0.4	GGCCAACGAGAGCGCTTCCGGCCGCAGCCACGGCGG	17	15	22	20	5	er	independent
seq1983_all_clean_seqs_gap0_no20_0.4	ACCGGAAGGGCGGGGGCGTGGCGAGGTACCGCAGAC	4	3	29	27	25	er	cooperative
seq1984_all_clean_seqs_gap0_no20_0.4	GGCTGGCCTAGGAACTTCCGCCACAAGTCCCGCCCC	17	15	21	19	4	er	independent
seq1985_all_clean_seqs_gap0_no20_0.4	GGACACAGGCTTCCGCGTTACCGACACCGCGTGGGG	12	10	27	25	15	er	independent
seq1986_all_clean_seqs_gap0_no20_0.4	AGTTGCTAAGGAAATGACTGCCCGCAGCGCCTGGCC	10	9	22	20	12	er	independent
seq1988_all_clean_seqs_gap0_no20_0.4	AACATTACGGAAGTTTCTCTACCCATGCGGTGTCTC	9	8	28	26	19	er	independent
seq1989_all_clean_seqs_gap0_no20_0.4	CGGGGCATGCCGGACGCTGTGGTCCTGAAGGCCTGG	12	11	20	18	8	er	independent
seq1990_all_clean_seqs_gap0_no20_0.4	GCAGAAGGAAGTGTGGCTTGGCGCGGTGGCTCACAC	7	6	24	22	17	er	independent
seq1991_all_clean_seqs_gap0_no20_0.4	AGATGCAGAACAGGAAGTGGTTTAGAAAGCCACTCT	13	12	18	16	5	er	independent
seq1993_all_clean_seqs_gap0_no20_0.4	CTTTTCCATGCAGGAAGTGGTTTTTAGAGTGTAGAG	13	12	18	16	5	er	cooperative
seq1994_all_clean_seqs_gap0_no20_0.4	GCGGAGGGAAGCGGAAATACTTGCGGTGGGGGCGAC	13	12	24	22	11	er	cooperative
seq1995_all_clean_seqs_gap0_no20_0.4	TTTCAAAACCCGGAAATGACCGCCAGGCTGGCATCA	12	11	20	18	8	er	independent
seq1997_all_clean_seqs_gap0_no20_0.4	ATGGCGGAGCGGAAGTCCCAGCCACAACGCGAAAAG	11	10	22	20	11	er	independent
seq199_all_clean_seqs_gap0_no20_0.4	GCCGGGCACCCCGGAAGACCGCTGGGAACCGGCTTT	13	12	19	17	6	er	independent
seq2000_all_clean_seqs_gap0_no20_0.4	CAGATCCGGCGTGGACGAAGCTCGGGAACCACAACA	5	3	29	27	24	er	independent
seq2001_all_clean_seqs_gap0_no20_0.4	TGAAACCCAGCAGGATGTGGGTTAACGGCAGGGGAG	13	12	18	16	5	er	cooperative
seq2002_all_clean_seqs_gap0_no20_0.4	CAAGGCACCAACGGATGTGGTATCTGGTGAGGGCTT	13	12	18	16	5	er	cooperative
seq2004_all_clean_seqs_gap0_no20_0.4	GCGCGGCGCGACCGGACGCTGCGGGCGGGGAAGAGG	14	13	22	20	8	er	cooperative
seq2005_all_clean_seqs_gap0_no20_0.4	AACAAACAGTAGGCAGGAAGTGGTTAAACCGAAAGG	16	15	21	19	5	er	cooperative
seq2006_all_clean_seqs_gap0_no20_0.4	GGGCAGGGCATTTCCTTTGTGGCTGGTGCTCACGGA	13	11	20	18	7	er	independent
seq2007_all_clean_seqs_gap0_no20_0.4	GCGCAAGGCGCTTCCTCCCCCGCAGCGCGAGCCCCA	13	11	20	18	7	er	independent
seq2009_all_clean_seqs_gap0_no20_0.4	AAGGGAGCCGCCCGGAAACCGCGCGGCAAAGATGCC	14	13	19	17	5	er	cooperative
seq2010_all_clean_seqs_gap0_no20_0.4	AGCCAACAGGAAGCTGCAGAGACTAAACCACAGCAA	9	8	28	26	19	er	cooperative
seq2012_all_clean_seqs_gap0_no20_0.4	GCCGGCGGCCGGAAGTCTATCCCGCAGAAGCGCAGC	11	10	22	20	11	er	cooperative
seq2013_all_clean_seqs_gap0_no20_0.4	GGAGGAAGGCAGGAAAGAAAGAGGTGGTTTCGGCAC	12	11	25	23	13	er	independent
seq2014_all_clean_seqs_gap0_no20_0.4	CTGAGGCGCGCCGGAAGGGCTAGCGGTCCCAGCATA	13	12	24	22	11	er	independent
seq2015_all_clean_seqs_gap0_no20_0.4	CTCACAACTCGCGTCCGGCGGAGACCACAATTCCCG	14	12	25	23	11	er	cooperative
seq2016_all_clean_seqs_gap0_no20_0.4	CGCCGGTCCCATATCCTTTCTGCGGGGTGAGCAGCA	14	12	23	21	9	er	independent
seq2017_all_clean_seqs_gap0_no20_0.4	CAGATTCCCGGAAAGGGGGACATGTAGCCGCAAAAG	10	9	28	26	18	er	cooperative
seq2018_all_clean_seqs_gap0_no20_0.4	CCCGGTGCACCGGATCCGACCACACCCTGGGTGGGC	12	11	20	18	8	er	ambiguous
seq201_all_clean_seqs_gap0_no20_0.4	GGCTAGCATCCGCTTCCCAGAGCCCCACAGCCGGGG	9	7	25	23	16	er	independent
seq2020_all_clean_seqs_gap0_no20_0.4	CCCAGCCCTGCTGCCGGATGTGGTGAGGCCCAGGTG	16	15	21	19	5	er	cooperative
seq2021_all_clean_seqs_gap0_no20_0.4	CCCGGAAACTCAACTGCCCACTGCTGCGGCCGCCAT	4	3	27	25	23	er	cooperative
seq2022_all_clean_seqs_gap0_no20_0.4	TCTGTCGTCCCACTTCCTGCTGCGGTTTCCACCTCG	15	13	23	21	8	er	cooperative
seq2023_all_clean_seqs_gap0_no20_0.4	CCCGCTTCCGCGTTTTACTCGGTGCCCGCAGCGCCG	7	5	26	24	19	er	independent
seq2024_all_clean_seqs_gap0_no20_0.4	TCTCTTCCTGTGATGGAAATACATTGAGGTTTGCGA	6	4	27	25	21	er	independent
seq2025_all_clean_seqs_gap0_no20_0.4	GCCGTGGGTACGACCGGAAGCCGCAGGTGGGTGAAG	16	15	21	19	5	er	ambiguous
seq2026_all_clean_seqs_gap0_no20_0.4	AATCATTTCCTGCCCTAACGTTTGTGGTCTGCCTAG	8	6	25	23	17	er	cooperative
seq2027_all_clean_seqs_gap0_no20_0.4	AGATGAGGAAGTTGGGGTTTAGAGTGGTTAAACTGT	7	6	25	23	18	er	independent
seq2028_all_clean_seqs_gap0_no20_0.4	TTCTCCACTTCCTTCTTTACCTCACCTACCACATAA	10	8	29	27	19	er	independent
seq2029_all_clean_seqs_gap0_no20_0.4	CAACACAGGATGTGCAGTATTATACCGCAAAGCACT	8	7	25	23	17	er	cooperative
seq202_all_clean_seqs_gap0_no20_0.4	AAGCTTCCTGGCCCTTTAAAAATGGCGGTTCCGCAC	6	4	26	24	20	er	independent
seq2030_all_clean_seqs_gap0_no20_0.4	TTCACAACACAGGATGTGCGGTATTATACGGCAAAG	12	11	19	17	7	er	cooperative
seq2031_all_clean_seqs_gap0_no20_0.4	TGCTTCTGAGGAAGTGATCTGTGGTCAAAGAAAGAA	10	9	22	20	12	er	cooperative
seq2032_all_clean_seqs_gap0_no20_0.4	GTAGCTCCTCCCACTTCCCGTGGTTTTCGGTTGAAC	16	14	21	19	5	er	cooperative
seq2033_all_clean_seqs_gap0_no20_0.4	AGCTAGGACAGGATGTGAAAACCACACTGACAAAGT	11	10	22	20	11	er	cooperative
seq2034_all_clean_seqs_gap0_no20_0.4	GTGGATTTCACATCCTGTCCTAGCGGTATGTTTGTC	13	11	24	22	11	er	independent
seq2035_all_clean_seqs_gap0_no20_0.4	AACACCTCACACTTCCTGCCCACAAGATAAGAGCCT	14	12	20	18	6	er	cooperative
seq2037_all_clean_seqs_gap0_no20_0.4	TTTGTAAGAGGAGGAAGTGGTTTGTAAGAGGAGAAA	13	12	18	16	5	er	cooperative
seq2038_all_clean_seqs_gap0_no20_0.4	AGTACGATGGGAGGAAGTGGTTTGTAAGAGGAGGAC	13	12	18	16	5	er	cooperative
seq2039_all_clean_seqs_gap0_no20_0.4	CGGCGCTCGCGGAAGTGCCGCGGTGCCTGCTCTGCA	11	10	21	19	10	er	independent
seq203_all_clean_seqs_gap0_no20_0.4	TTGCGTCACGTCCGGCCTGCGAGTTACCGCCCACTC	11	9	27	25	16	er	independent
seq2040_all_clean_seqs_gap0_no20_0.4	GCACCGTGGCACTTCCGCGAGCGCCGCAGGCCCTGC	14	12	24	22	10	er	independent
seq2041_all_clean_seqs_gap0_no20_0.4	GCGAGACGCGGAAGAGGCTTGCGGTTGACCAAAGAA	10	9	22	20	12	er	cooperative
seq2042_all_clean_seqs_gap0_no20_0.4	CCCTACTCAGGAGGATGTGGTTGGAGAACCCGCTGA	13	12	18	16	5	er	cooperative
seq2043_all_clean_seqs_gap0_no20_0.4	AACTGTCTCTACCCAGGAAGTGGTTTTATTTAAAAG	16	15	21	19	5	er	cooperative
seq2047_all_clean_seqs_gap0_no20_0.4	TGATTAAAAACAGGATGTGGGTGAATAGTCATGCAT	13	12	18	16	5	er	independent
seq2048_all_clean_seqs_gap0_no20_0.4	CATGGTTGTTATTTCCTCACCACAATATGTGACATT	14	12	20	18	6	er	cooperative
seq204_all_clean_seqs_gap0_no20_0.4	GGGGAAGAGGAAGCTGTGTCCGCGGTGCAAGGGGTT	9	8	23	21	14	er	independent
seq2050_all_clean_seqs_gap0_no20_0.4	CAGACAGGAGGCGGATGTGGGTGGCGCAGAATGAGC	13	12	18	16	5	er	cooperative
seq2051_all_clean_seqs_gap0_no20_0.4	GAGAAAAGAGACTGAGGATGTGGTTTGGGGTGTGGG	16	15	21	19	5	er	cooperative
seq2052_all_clean_seqs_gap0_no20_0.4	TGAGCACAGTATTTCCTGTGGTTTCTATTGCATTTC	14	12	19	17	5	er	cooperative
seq2053_all_clean_seqs_gap0_no20_0.4	ATAGAAACTACAGGAAATACTGTGGTCAGGTTTTGA	13	12	23	21	10	er	cooperative
seq2054_all_clean_seqs_gap0_no20_0.4	ATGTGCCCAAAGGATGTCACCGCAAAGATCATAGGA	12	11	20	18	8	er	cooperative
seq2055_all_clean_seqs_gap0_no20_0.4	TTGAAAAGGAAGTTCATTTGTACTGAGGTGGTTTTA	8	7	29	27	21	er	independent
seq2056_all_clean_seqs_gap0_no20_0.4	GTGTGCGTGAGAAGAGGAAGTGGTTAGGAAGACACA	16	15	21	19	5	er	cooperative
seq2057_all_clean_seqs_gap0_no20_0.4	TAAGAGATTTCCTGTAAAGGTAACCACCAGCAAAGA	10	8	24	22	14	er	independent
seq2058_all_clean_seqs_gap0_no20_0.4	TAAAGAAACAGGATGACTGTGGTTTACTGCGAGCAT	11	10	20	18	9	er	cooperative
seq2059_all_clean_seqs_gap0_no20_0.4	CTAACAGCAGGAAGTGCTTGGTGGTTTAGCACCTCA	10	9	22	20	12	er	cooperative
seq205_all_clean_seqs_gap0_no20_0.4	GGACTGCGTTTCCGGACACTGCGGGTGCCGGTAGCC	11	9	22	20	11	er	independent
seq2060_all_clean_seqs_gap0_no20_0.4	CCAAGCACTTCCTGCTGTTAGCTTTGTGGGCTGAGT	10	8	27	25	17	er	independent
seq2061_all_clean_seqs_gap0_no20_0.4	GCTCGCGTCATCCTGCAGCGCCGACACCACAGACAC	11	9	27	25	16	er	independent
seq2062_all_clean_seqs_gap0_no20_0.4	AGGGCTGAAACAGGATGTGGTGAGTGAGGTAGGGTG	13	12	18	16	5	er	cooperative
seq2063_all_clean_seqs_gap0_no20_0.4	GACTCCCTCAGCGGATGCGGGTGCTGCTGCTGCTGC	13	12	18	16	5	er	independent
seq2064_all_clean_seqs_gap0_no20_0.4	CAGCAGCACCTGCATCCGCTGCGGGAGTCCGAGCCG	15	13	22	20	7	er	independent
seq2065_all_clean_seqs_gap0_no20_0.4	AAGGCAAACAGGAAATCATAACCACAAACCAGGAAC	11	10	22	20	11	er	cooperative
seq2067_all_clean_seqs_gap0_no20_0.4	AAACCAGAGAGGAAGTGGCACCACATGGCCAGACTG	11	10	21	19	10	er	independent
seq2068_all_clean_seqs_gap0_no20_0.4	GTTCCTTTGAAAGCAGGATGTGGTTTGCCCCAGCTT	16	15	21	19	5	er	cooperative
seq206_all_clean_seqs_gap0_no20_0.4	TGGGAAGGGTGAGGAGGAAGCGGTGGCCTTGCTCTG	16	15	21	19	5	er	independent
seq2071_all_clean_seqs_gap0_no20_0.4	TAAACGTCAGCTTCCTTTGTGGCTTACCCTCCCGCC	13	11	20	18	7	er	independent
seq2072_all_clean_seqs_gap0_no20_0.4	AAATGTGGCCGGATGCTCTGTGGGCGGGCGGCAGCT	11	10	21	19	10	er	independent
seq2073_all_clean_seqs_gap0_no20_0.4	GCAGAAGGATTTCCTGTTTCAGGCAACCACAGCGAC	12	10	27	25	15	er	cooperative
seq2074_all_clean_seqs_gap0_no20_0.4	ATGGAAAGGAAGTCGGTGGGAAACCGCCTCAGCGGT	8	7	24	22	16	er	independent
seq2075_all_clean_seqs_gap0_no20_0.4	CTCCGCCTTTCACTTCCTAGTAACCGCCCTCCCTTG	15	13	24	22	9	er	independent
seq2076_all_clean_seqs_gap0_no20_0.4	GTGGCCTCTTCAACAGGAAACCACAATATTTTTGTT	16	15	21	19	5	er	cooperative
seq2077_all_clean_seqs_gap0_no20_0.4	TGTGGAGACAGGAAGCACTAACCTCAAACCTCTTTC	11	10	22	20	11	er	cooperative
seq2078_all_clean_seqs_gap0_no20_0.4	AACAGCTTCCGGCACGGGGGCTGTGGTTGTGTTGGA	8	6	24	22	16	er	independent
seq2079_all_clean_seqs_gap0_no20_0.4	TGCGAGGTTGCCAGGAAACCGCGAAGCCGAGGTCCC	14	13	19	17	5	er	cooperative
seq2080_all_clean_seqs_gap0_no20_0.4	TGCAAATCCACTTCCCTTGTGGTACTTGCTTGTTGC	13	11	20	18	7	er	independent
seq2081_all_clean_seqs_gap0_no20_0.4	CCAGCCACTTCCGCTCGTCCGCCTAATACCGCGCCT	10	8	29	27	19	er	independent
seq2082_all_clean_seqs_gap0_no20_0.4	TTCATCTACTTCCCGCCACACCCACAGAGAAGCCCA	11	9	22	20	11	er	independent
seq2083_all_clean_seqs_gap0_no20_0.4	GACTGCGCCGGACGCGCCAGCCCTGCGGGATGACGT	10	9	26	24	16	er	ambiguous
seq2084_all_clean_seqs_gap0_no20_0.4	TACCCAGAAAGGAAGTGGAACCTGCGGTGAGGCCCC	11	10	25	23	14	er	cooperative
seq2085_all_clean_seqs_gap0_no20_0.4	TGTCTCTGCCGCCGGAAACCGCGCCGTAGATCATGC	14	13	19	17	5	er	cooperative
seq2086_all_clean_seqs_gap0_no20_0.4	GCCGTAGCGGAAGAGTGTTCGTGGTCATGTGACGCC	9	8	22	20	13	er	independent
seq2087_all_clean_seqs_gap0_no20_0.4	TGGCAGGATGCCGTTAAATATGTAACCACATGTCTC	6	5	26	24	20	er	cooperative
seq2088_all_clean_seqs_gap0_no20_0.4	GCAGCTCTGGCAGGATGCGGTTAAATATGTATCCAC	13	12	18	16	5	er	cooperative
seq2089_all_clean_seqs_gap0_no20_0.4	TGCCTCTTCCTGTGGCTGGGCTGTATCTGACCACAC	8	6	31	29	23	er	independent
seq2090_all_clean_seqs_gap0_no20_0.4	GGCTTCCTGCCCAACTACCAAGAAAAAGCCACAAAG	5	3	29	27	24	er	cooperative
seq2091_all_clean_seqs_gap0_no20_0.4	CTCTAGAGGCTTCCTGCCCAACCACCAAGAAAAAGC	12	10	22	20	10	er	independent
seq2092_all_clean_seqs_gap0_no20_0.4	CCAGTACCCCACTTCCTGACCAAACCACAAAGGTCA	14	12	25	23	11	er	cooperative
seq2093_all_clean_seqs_gap0_no20_0.4	CCCTCATCTTCCTGCTTCAGGCAGCTGTGGTTTACC	10	8	28	26	18	er	cooperative
seq2097_all_clean_seqs_gap0_no20_0.4	TTCTTGTTTCCTGTCAAGGGAGGCTCTGACCACCTC	9	7	30	28	21	er	independent
seq2098_all_clean_seqs_gap0_no20_0.4	CACCTCCTCTCCGGATGCGGTTTGTTCTGCTTGTAG	13	12	18	16	5	er	cooperative
seq2099_all_clean_seqs_gap0_no20_0.4	GCTTCTGAGGAAGTGCGTTCTGTGGGTAGGTGGAGT	9	8	23	21	14	er	independent
seq209_all_clean_seqs_gap0_no20_0.4	CCTCCTCCAGACCATCCTGGAAACCACTGCCGTTCT	15	13	24	22	9	er	independent
seq341_all_clean_seqs_gap0_no20_0.4	CCTCCTCCAGACCATCCTGGAAACCACTGCCGTTCT	15	13	24	22	9	er	independent
seq2100_all_clean_seqs_gap0_no20_0.4	AGGAGTGAGGAAGTGAGGCTGGCCTTGTGGGTGTGG	9	8	28	26	19	er	independent
seq2101_all_clean_seqs_gap0_no20_0.4	TAGCCGTACGGAAATGTTTGTGGTTCTCTGCATCTA	10	9	21	19	11	er	cooperative
seq2102_all_clean_seqs_gap0_no20_0.4	GGTTTAACGTTTCCGGTTTGTGGCTAGTTTCTTGTC	12	10	21	19	9	er	ambiguous
seq2103_all_clean_seqs_gap0_no20_0.4	TAGCCACGAACCGGAAACGTTAAACCACAGCTCCGT	13	12	25	23	12	er	cooperative
seq2104_all_clean_seqs_gap0_no20_0.4	ACAGGAAGGAACTTGCTCAGGGCCACACCGCAGAGT	4	3	28	26	24	er	cooperative
seq2105_all_clean_seqs_gap0_no20_0.4	CAACTCACATCCTCTGGCAACAACCACTAATCCACT	10	8	24	22	14	er	independent
seq2106_all_clean_seqs_gap0_no20_0.4	CCGCTTCCTTAGAGGTTAAGTGGTGGTGGTTCAGTT	6	4	27	25	21	er	independent
seq2108_all_clean_seqs_gap0_no20_0.4	ACCAGGATGTAGTTTAGCTTAGGGGTGGTTATATCG	5	4	26	24	21	er	independent
seq2109_all_clean_seqs_gap0_no20_0.4	CCATCCAGGAAGCTTATGGTGCGACCGCAGTGTGCC	8	7	25	23	17	er	cooperative
seq2110_all_clean_seqs_gap0_no20_0.4	CACCGACCGGAAGGGCCCCAAGGATCCCCGCAGCAG	9	8	28	26	19	er	independent
seq2112_all_clean_seqs_gap0_no20_0.4	CTAGGGAGAGGATGTGAGTTTGTCTGTGGGGGTGGT	10	9	27	25	17	er	independent
seq2113_all_clean_seqs_gap0_no20_0.4	GAGAGGAGGATGTTGTCAGATACCCACAAATGAGAA	8	7	24	22	16	er	independent
seq2114_all_clean_seqs_gap0_no20_0.4	CCCTGACTTTTACGGAAATAGCGGTCCAAAAGCGCC	14	13	22	20	8	er	independent
seq2115_all_clean_seqs_gap0_no20_0.4	GACTTTTACGGAAATAGCAGTCCAAAACCGCGTCTA	10	9	28	26	18	er	cooperative
seq2116_all_clean_seqs_gap0_no20_0.4	ACATTTCCGTTCAGCTCAGTGTTCGCGGTGCGAGAC	6	4	26	24	20	er	independent
seq2117_all_clean_seqs_gap0_no20_0.4	TGTGTCACTTCCCTATCTGTTGCGGTTGTTCACTCC	10	8	23	21	13	er	cooperative
seq2118_all_clean_seqs_gap0_no20_0.4	GGGCCCACATCCGGCGCGCGCAACCGCAGCCTACTG	10	8	24	22	14	er	cooperative
seq2120_all_clean_seqs_gap0_no20_0.4	CGGGCGAGCGCAGGATGCGGTTGTCGAACGCGCGGC	13	12	18	16	5	er	cooperative
seq2121_all_clean_seqs_gap0_no20_0.4	GTCAGGGGAACAGGATGTGGGTGGGAGCCAGCCCCA	13	12	18	16	5	er	independent
seq2122_all_clean_seqs_gap0_no20_0.4	GCAGGCGAAGGCGGAACTGGCGTGGTCAAACCAACC	13	12	23	21	10	er	independent
seq2123_all_clean_seqs_gap0_no20_0.4	GGACAGGAAGTTCCTGCAGCTTCTACCACAAACCTA	6	5	26	24	20	er	cooperative
seq2125_all_clean_seqs_gap0_no20_0.4	GGAGTGAGGAGGAAGCGGAGGCGAGACCGCGCTCAA	11	10	27	25	16	er	ambiguous
seq2126_all_clean_seqs_gap0_no20_0.4	CTGGGGAGGAAGCCTGAGGTGTGTGGTTTTGTTAAC	8	7	24	22	16	er	cooperative
seq2127_all_clean_seqs_gap0_no20_0.4	TTGCCATTCCAGGAAATGAGCTTACCACATTGACTG	12	11	25	23	13	er	cooperative
seq2128_all_clean_seqs_gap0_no20_0.4	GCAACAGGAAGGACCAAGTCCCCTCCCGCAATTTTA	7	6	26	24	19	er	independent
seq2129_all_clean_seqs_gap0_no20_0.4	AGTGCAGAGTGGACAGGATGTGGTGGAGGTGAGAGA	16	15	21	19	5	er	cooperative
seq212_all_clean_seqs_gap0_no20_0.4	TCGCTTCCTGCTCCACTTCTCGGCGCCCACATCTCC	6	4	27	25	21	er	independent
seq2130_all_clean_seqs_gap0_no20_0.4	CCTCACTAACATCCTGTTGAGGTGTCCCACAAACCA	12	10	27	25	15	er	independent
seq2131_all_clean_seqs_gap0_no20_0.4	CCCCCACATCCTGTTTGGTTTGTGGGACACCTCAAC	9	7	23	21	14	er	independent
seq2132_all_clean_seqs_gap0_no20_0.4	CAAGGTTCCTCCGCTTCCTGCCCGCAGGCCGAACCT	16	14	22	20	6	er	cooperative
seq2135_all_clean_seqs_gap0_no20_0.4	AGGGACCCGGATGTCTGGTCTGCGGCTGCTCCTCTA	9	8	23	21	14	er	independent
seq2136_all_clean_seqs_gap0_no20_0.4	GCTCCTGGCCCGCACTTCCGACCACACACTGGGGAC	17	15	22	20	5	er	independent
seq2137_all_clean_seqs_gap0_no20_0.4	CTCTGAGCAGGAAGTGACAAAACCACGCAGGGCAGG	10	9	23	21	13	er	cooperative
seq2138_all_clean_seqs_gap0_no20_0.4	GTTTACAGGGGACAGGAAATGTGGGTGAACTCAGCC	15	14	22	20	7	er	independent
seq2139_all_clean_seqs_gap0_no20_0.4	GACGCATAAACAGGAAGGCCTGCGGGAGGGCCCGCC	13	12	23	21	10	er	independent
seq213_all_clean_seqs_gap0_no20_0.4	CTCTGTCAGGAAAATACACTTGGATGTGGTGACAGA	9	8	27	25	18	er	ambiguous
seq2141_all_clean_seqs_gap0_no20_0.4	TCGCAGAGAATTCTTCCGGAGGCGGTCACAGACATC	15	13	23	21	8	er	independent
seq2142_all_clean_seqs_gap0_no20_0.4	ACGTGATGGCAGTCTTCCTGCCCACAAGTTCTGGTC	16	14	22	20	6	er	independent
seq2143_all_clean_seqs_gap0_no20_0.4	CCTGTACGGAAGCTACTCTGGTTTCATGTGGTTTCA	8	7	29	27	21	er	cooperative
seq2144_all_clean_seqs_gap0_no20_0.4	GAAGCTACTCTGGTTTCCTGTGGTTTTCTGAGCACT	16	14	21	19	5	er	cooperative
seq2145_all_clean_seqs_gap0_no20_0.4	CCTTTACTTCCTTTTACTTCTAACCACAGAATTAAA	9	7	24	22	15	er	cooperative
seq2146_all_clean_seqs_gap0_no20_0.4	TCACCCTCTCACTTCCTGCGGGTCCCAGGCTCAGGC	14	12	19	17	5	er	independent
seq2147_all_clean_seqs_gap0_no20_0.4	CAGTGAACAGTTTCCTGTTCCTGTGGTTTTGACTTT	13	11	24	22	11	er	cooperative
seq2148_all_clean_seqs_gap0_no20_0.4	GTCCTCCAGGAAGCCCGCGCTAACCACCGTGCCTTT	9	8	24	22	15	er	independent
seq214_all_clean_seqs_gap0_no20_0.4	GAGTGGGGGTGGGGAGGAAGCCACAGGGCCGGGCTG	16	15	21	19	5	er	independent
seq2150_all_clean_seqs_gap0_no20_0.4	AGCACCCCACATCCTGCACCCCACAACCCAGATCCC	12	10	21	19	9	er	ambiguous
seq2151_all_clean_seqs_gap0_no20_0.4	CTGCCTTGCTTTTCCGGTCGCCGCGGTCCTCTGCGC	13	11	24	22	11	er	ambiguous
seq2152_all_clean_seqs_gap0_no20_0.4	TGTTTTTGTTTCCGTTTACAAACCACAACAAAGGTG	11	9	23	21	12	er	cooperative
seq2154_all_clean_seqs_gap0_no20_0.4	GACAGTCATGTTTCAGGATGTGGTTTTAGCCAAAGG	16	15	21	19	5	er	cooperative
seq2155_all_clean_seqs_gap0_no20_0.4	ATAGTCACCGTTCCGGCCCTCCTCCACCGCACTTCT	12	10	27	25	15	er	ambiguous
seq2156_all_clean_seqs_gap0_no20_0.4	GTGCTCCTCGCTTCCTCCGCGGTCTTCCGAGCGGTC	13	11	20	18	7	er	independent
seq2157_all_clean_seqs_gap0_no20_0.4	CTCCCCCTTTTTTTCCTGTGGTTTCATTGCATGTTG	14	12	19	17	5	er	cooperative
seq2158_all_clean_seqs_gap0_no20_0.4	CTTGTTCTATTTCCTGTTTGTGGTGAGTGACTGTCT	12	10	21	19	9	er	cooperative
seq215_all_clean_seqs_gap0_no20_0.4	TTCTGACTCACCTTCCTGTAGGTTGGTTTTCTGCAT	14	12	24	22	10	er	independent
seq2160_all_clean_seqs_gap0_no20_0.4	CCTACACTTCCCAGAGAACCTAGCGGTTACGCCAAC	9	7	24	22	15	er	cooperative
seq2162_all_clean_seqs_gap0_no20_0.4	GAGCAACCAGGAAGAGCTTTGGCTGTGGGCTAAGAT	10	9	26	24	16	er	independent
seq2163_all_clean_seqs_gap0_no20_0.4	TATGTCTGACTTCCGCTCGTGGTTTCCATCTTAGCC	12	10	20	18	8	er	cooperative
seq2165_all_clean_seqs_gap0_no20_0.4	TCTGGAGAAGCAGGATGTGGTTTGCAAGAGGCTTGC	13	12	18	16	5	er	cooperative
seq2166_all_clean_seqs_gap0_no20_0.4	CTCATCAGTCATCCGGCTGGACCGCAGGAGCTCTCC	12	10	22	20	10	er	independent
seq2167_all_clean_seqs_gap0_no20_0.4	GGTGCCAAGGGCAGAGGATGTGGTGAGGTGTGGAGG	16	15	21	19	5	er	cooperative
seq2168_all_clean_seqs_gap0_no20_0.4	GGTACCAAGGGCAGAGGATGTGGTGAGGTGTGGAGG	16	15	21	19	5	er	cooperative
seq2169_all_clean_seqs_gap0_no20_0.4	CCACTCCCAGCTCCATCCTGTGGGTAGAACTCAGTG	16	14	21	19	5	er	independent
seq2170_all_clean_seqs_gap0_no20_0.4	GCCGATGAGGAAGTGAGGGCCAACCACACTGCTCAG	9	8	24	22	15	er	independent
seq2171_all_clean_seqs_gap0_no20_0.4	GGAGGAAGAGAGGAAACGGGGGCGGCCGCAGCTTCT	12	11	26	24	14	er	cooperative
seq2172_all_clean_seqs_gap0_no20_0.4	GACATCTTCCGGTTGCTACAGGTTACGGCGGTTGCT	8	6	29	27	21	er	independent
seq2173_all_clean_seqs_gap0_no20_0.4	CTGCTGACCAAAACAGGATGTGGTCTACACAAAGTG	16	15	21	19	5	er	cooperative
seq2175_all_clean_seqs_gap0_no20_0.4	CTACCGGAAATGCAGCACCACGTAAAATGCGGTCGG	6	5	30	28	24	er	cooperative
seq2176_all_clean_seqs_gap0_no20_0.4	GGACCGGAAGTAGGTTTCTACCCGACCGCATTTTAC	6	5	26	24	20	er	cooperative
seq2178_all_clean_seqs_gap0_no20_0.4	ACCTTCGCCGGATGCTGTGGCTGAAACCACAGCATT	10	9	27	25	17	er	cooperative
seq2179_all_clean_seqs_gap0_no20_0.4	ATTTCCATTTCCGGACTCTTCTCCTGCCCGCAGGGC	10	8	28	26	18	er	independent
seq217_all_clean_seqs_gap0_no20_0.4	GCACTACATTTCCCAGCTTTCCTCGCGGTAAAGAGA	11	9	26	24	15	er	independent
seq2180_all_clean_seqs_gap0_no20_0.4	TCCTTAATGGTTCCGGCGGCAGGGACCGCAGCGACG	12	10	26	24	14	er	independent
seq2181_all_clean_seqs_gap0_no20_0.4	TCCCGGCGTTCTTCCGCTGGCTCAGCCGCAAGTACC	13	11	26	24	13	er	cooperative
seq2182_all_clean_seqs_gap0_no20_0.4	CCACTGCTTTGTTTCCTCTCCAGACCGCGCATTTTG	14	12	25	23	11	er	independent
seq2183_all_clean_seqs_gap0_no20_0.4	ACCTCTTCCGAGACCCAAAATGCGCGGTCTGGAGAG	7	5	25	23	18	er	independent
seq2184_all_clean_seqs_gap0_no20_0.4	ATCTTCCGTAGCAGTCAGGTGTTTTGTGGTTTGCAG	5	3	27	25	22	er	ambiguous
seq2187_all_clean_seqs_gap0_no20_0.4	GGGGCTGTGCTTCCGGCTGTTTGTGCGGTTTTGTGC	12	10	26	24	14	er	cooperative
seq2188_all_clean_seqs_gap0_no20_0.4	GACTGGTTTCCTGGTTTTGATGTGGTTTAGAGAAAA	9	7	23	21	14	er	ambiguous
seq2189_all_clean_seqs_gap0_no20_0.4	TCGTCTCTTCCGGATCCCTCCTGCACCGCCCACAGC	9	7	30	28	21	er	independent
seq2191_all_clean_seqs_gap0_no20_0.4	TTCGGATTCCCGGAAGAACCCGCAGCAGCTCCCAGG	12	11	20	18	8	er	independent
seq2192_all_clean_seqs_gap0_no20_0.4	GAGACTTTCGCTTCCGGCTGCCGCAGGCGCTTCGCT	13	11	21	19	8	er	independent
seq2193_all_clean_seqs_gap0_no20_0.4	TGCGAGCACCCGGAAGCCGCTTGCGGGCTCCCGGAG	12	11	24	22	12	er	cooperative
seq2194_all_clean_seqs_gap0_no20_0.4	AGGGCGCCGCTTCCGGGAGCCCGCAAGCGGCCTCCG	12	10	21	19	9	er	independent
seq2195_all_clean_seqs_gap0_no20_0.4	TCATATCCGGCAGGAATGGGTTTTGTGGCTTTGTGC	6	4	26	24	20	er	cooperative
seq2196_all_clean_seqs_gap0_no20_0.4	TGAGCACTGAGCACTTCCTGTGGCTTCTGAAGCTCC	16	14	21	19	5	er	independent
seq2197_all_clean_seqs_gap0_no20_0.4	GCAGCTGCAAACAGGAAACCACAGCAGCGTAGCGGA	14	13	19	17	5	er	cooperative
seq2200_all_clean_seqs_gap0_no20_0.4	GGGCCCCCGGAAAGAGCTTTGACCGCTCGAGCCTGC	9	8	23	21	14	er	independent
seq2201_all_clean_seqs_gap0_no20_0.4	CAGAAAGAGGAAATGATGCGAGTCCACACCGCAGGC	9	8	29	27	20	er	cooperative
seq2202_all_clean_seqs_gap0_no20_0.4	GCCTGCAGCTTCTTCCTGTGGCTTCTGCATCTCAGG	14	12	19	17	5	er	independent
seq2203_all_clean_seqs_gap0_no20_0.4	CCGCTGACATCCGCTTGGCCTGCGGCTTCTTTCTGT	10	8	23	21	13	er	independent
seq2204_all_clean_seqs_gap0_no20_0.4	TGTCATCCCGGAAACTGATAACAAGACCGCGAGTCA	10	9	27	25	17	er	independent
seq2206_all_clean_seqs_gap0_no20_0.4	GTCGTCCCGGAAACCGGGATGCGGTTATCAGAGCGA	9	8	22	20	13	er	cooperative
seq2207_all_clean_seqs_gap0_no20_0.4	GCCGCTGGGTAGGCGGAAGTAGCCGCAGGCATGGCA	15	14	23	21	8	er	independent
seq2209_all_clean_seqs_gap0_no20_0.4	GCCTGAGCGGAAACCCGGCGCCACCACAAGATGGCA	9	8	24	22	15	er	cooperative
seq220_all_clean_seqs_gap0_no20_0.4	CTTGTTATCCTTCCGGAGGCGGTAACTCATGAGAGA	12	10	20	18	8	er	independent
seq2211_all_clean_seqs_gap0_no20_0.4	GCTTAGGCTCTTTCCTGTGTGGTGAGCACTAACCTC	13	11	20	18	7	er	independent
seq2212_all_clean_seqs_gap0_no20_0.4	CAAGCCAACATCCTGACAGTTTAGAAACCACAGGAG	11	9	28	26	17	er	cooperative
seq2213_all_clean_seqs_gap0_no20_0.4	ACGGTGTGTCTCATTTCCTGTGGGTAACAGGCACCA	16	14	21	19	5	er	independent
seq2215_all_clean_seqs_gap0_no20_0.4	GCGCACGCGCGTTGTTTCCGCGGTAGTCAGGGCAGT	17	15	21	19	4	er	ambiguous
seq2216_all_clean_seqs_gap0_no20_0.4	TCCCGAGAGCCGGAAGCAGCCGCAGGCCCCGCCACA	12	11	20	18	8	er	independent
seq2217_all_clean_seqs_gap0_no20_0.4	CCCGGACCGTTTCCGTGCTGTGGTCCCGGGTTCTGG	12	10	21	19	9	er	independent
seq2219_all_clean_seqs_gap0_no20_0.4	CCCCGCCTCTTCCGCTTCTGTGGTCTGATCTGCCTG	11	9	21	19	10	er	cooperative
seq2220_all_clean_seqs_gap0_no20_0.4	GTGCAGGCCGGAAGGAAAAGGGTTGTGGGGCTCATT	10	9	26	24	16	er	independent
seq2221_all_clean_seqs_gap0_no20_0.4	GCACAGGCCGGAAGGAAAAGGGTTGTGGGGCTCATT	10	9	26	24	16	er	independent
seq2222_all_clean_seqs_gap0_no20_0.4	GAGCACAGGAAAAGCTGGTGCCAACCACAAGTGCTT	8	7	25	23	17	er	cooperative
seq2223_all_clean_seqs_gap0_no20_0.4	CTAAGTGCTCTTCCTGCCAACCTGTGGGCGCCTGGC	12	10	25	23	13	er	independent
seq2224_all_clean_seqs_gap0_no20_0.4	GCCCAGGCAGGAAGCCAGGCGCCCACAGGTTGGCAG	10	9	23	21	13	er	independent
seq2228_all_clean_seqs_gap0_no20_0.4	AGCGGCCTGGGAGGAGGATGTGGTTACGTGGAGACC	16	15	21	19	5	er	cooperative
seq2229_all_clean_seqs_gap0_no20_0.4	CAGGAGCAGTGTAGAGGAAGTGGTTTCCATCACGGA	16	15	21	19	5	er	cooperative
seq2230_all_clean_seqs_gap0_no20_0.4	CTTCGGCCTTCCGTGATGGAAACCACCTCCTCTACA	10	8	23	21	13	er	independent
seq2231_all_clean_seqs_gap0_no20_0.4	TGAGTCACAGAGACAGGATGTGGTGCAGGGGGTATT	16	15	21	19	5	er	ambiguous
seq2232_all_clean_seqs_gap0_no20_0.4	AGCGGCCGAAGGAAGTGACGTTTGCGGCAGTAAGGC	11	10	25	23	14	er	independent
seq2233_all_clean_seqs_gap0_no20_0.4	TTTTCCGACGGAAGCCTTACTGCCGCAAACGTCACT	10	9	23	21	13	er	independent
seq2234_all_clean_seqs_gap0_no20_0.4	TACACTCCCACATCCGCTGCGGCGCAACTCACAACA	13	11	20	18	7	er	ambiguous
seq2235_all_clean_seqs_gap0_no20_0.4	ACAGGAAATGACATCAGAATCTCCAAACCACAACCA	4	3	28	26	24	er	cooperative
seq2236_all_clean_seqs_gap0_no20_0.4	TCGCCCGCCGCTTCCTGTCGCGGCGCCGCAGAGGCC	13	11	26	24	13	er	independent
seq2237_all_clean_seqs_gap0_no20_0.4	GGCCGTTCTTCCGCCTGCAGGGTGGTCAGCGGAGGT	10	8	23	21	13	er	independent
seq2238_all_clean_seqs_gap0_no20_0.4	GGCCAGGCAGGAAGTCCCGCGCCACAAGCGGCCGTC	10	9	22	20	12	er	independent
seq2239_all_clean_seqs_gap0_no20_0.4	GGTTTCGCTTCCGGGTTAGGCGGCCGCAGAAGCGTA	10	8	24	22	14	er	cooperative
seq223_all_clean_seqs_gap0_no20_0.4	ACCCCAGCCGGATCCTCTGCTTATCTCCCACATGCA	10	9	28	26	18	er	independent
seq2240_all_clean_seqs_gap0_no20_0.4	GAGGGGTGGGGGAGGAAGGCTGCGGTTTCTGCTGGG	14	13	23	21	9	er	cooperative
seq2241_all_clean_seqs_gap0_no20_0.4	AAGTTCTTCCGGGTCTGCAGTCTGTGGTGTGTTTGC	8	6	25	23	17	er	independent
seq2242_all_clean_seqs_gap0_no20_0.4	CTGAAGGCTGGGGAGGAAGTGACCGCCCTCATATGC	15	14	23	21	8	er	independent
seq2243_all_clean_seqs_gap0_no20_0.4	CCGATTTCCCCGGACGTGGTGAGACCGCGCTTCGTC	12	11	25	23	13	er	cooperative
seq2244_all_clean_seqs_gap0_no20_0.4	TCCCACTGCGACGGAAGCACAGCGGTTAAGATTGCA	13	12	23	21	10	er	cooperative
seq2245_all_clean_seqs_gap0_no20_0.4	TGCAGTCTCAACTTCCTGCGGTCAAGTGATCCTTCA	14	12	19	17	5	er	cooperative
seq2246_all_clean_seqs_gap0_no20_0.4	GGCTTTTCCGGGATCCCTTTCGCCTCATCACCGCAG	7	5	31	29	24	er	independent
seq2247_all_clean_seqs_gap0_no20_0.4	CGGCAGGCAAGCAGGAAACCGCGAGTGGAGAAAGGG	14	13	19	17	5	er	cooperative
seq2248_all_clean_seqs_gap0_no20_0.4	TCGGAACGGAAGGGAGGCACGAAACCGCGAGTGGAG	8	7	25	23	17	er	cooperative
seq2249_all_clean_seqs_gap0_no20_0.4	AGCTTGACGAAGGCTTCCTGTGGTTTGGGTTGATGT	16	14	21	19	5	er	cooperative
seq224_all_clean_seqs_gap0_no20_0.4	GTCGTCAGCGTCTTCCTGTCAGCGGTCGGCAGAGCC	14	12	23	21	9	er	independent
seq2250_all_clean_seqs_gap0_no20_0.4	CAGTCAGACGGAAGCCCGGCTTCTGTGGTGCCTGCC	10	9	26	24	16	er	independent
seq2251_all_clean_seqs_gap0_no20_0.4	GTTCAGCAGGAAGTGGATGTGGATGTGTGGTTGCCA	9	8	28	26	19	er	cooperative
seq2252_all_clean_seqs_gap0_no20_0.4	GAGGGGAGGATGTCTGAGCTTTTAATTGTGGTTTCA	8	7	29	27	21	er	cooperative
seq2253_all_clean_seqs_gap0_no20_0.4	GTATGGGAAGTGATCTGGCTGCAAACCGCAAGAGAG	6	5	26	24	20	er	cooperative
seq2256_all_clean_seqs_gap0_no20_0.4	CCTGCCGAGGAAGTCCCACGTCACTGCGGTTAGAGT	9	8	27	25	18	er	cooperative
seq2257_all_clean_seqs_gap0_no20_0.4	ATACAGACACAGGAAGTTGTGGGGAGTGCAAAAGCC	12	11	20	18	8	er	independent
seq2258_all_clean_seqs_gap0_no20_0.4	GCTACGGGTTCCCCGGATGGAGCCGCAGTCCGGCCG	15	14	23	21	8	er	independent
seq2259_all_clean_seqs_gap0_no20_0.4	GGTGGCAACATCCTGGGGAGGGGAACCCACAGGGGA	11	9	27	25	16	er	independent
seq225_all_clean_seqs_gap0_no20_0.4	TTTATCATGAATGCAGGATGTGGGCAAACTCGCATC	16	15	21	19	5	er	cooperative
seq2260_all_clean_seqs_gap0_no20_0.4	GCTTCTTCAGCCACATCCTGACCACAGCCCAGATTC	16	14	22	20	6	er	cooperative
seq2261_all_clean_seqs_gap0_no20_0.4	GAGAGCTGAGCGGAAGCTCAGCTGTGGGGCTGGTTG	12	11	25	23	13	er	independent
seq2262_all_clean_seqs_gap0_no20_0.4	CGACAGAGGACACTTCCTTTTGCGGGTGGCGGCGAA	15	13	23	21	8	er	cooperative
seq2263_all_clean_seqs_gap0_no20_0.4	GAGGAGGTGGGGAAGTGCTGTGGTTCCTCCCGTCAT	11	10	21	19	10	er	independent
seq2264_all_clean_seqs_gap0_no20_0.4	TCCCGGGGAGGAAGTGGCGAGAATGCGGGGGTGGGC	10	9	26	24	16	er	independent
seq2266_all_clean_seqs_gap0_no20_0.4	GACACAAGACAGTTTCCGTCAGTGGTTAAGCCCTAA	15	13	23	21	8	er	independent
seq2267_all_clean_seqs_gap0_no20_0.4	GCTGCTTCCGGCCGCTGGTCGCAGGGCTGCGGGACT	7	5	30	28	23	er	independent
seq2268_all_clean_seqs_gap0_no20_0.4	ATGTCTTCCTGTACAGGAACTGGGTCCCAGCCGCAG	7	5	31	29	24	er	ambiguous
seq2269_all_clean_seqs_gap0_no20_0.4	TGGCTTCCTGTCTGTCCTTCATCAGCCCACAGAGGC	6	4	27	25	21	er	independent
seq226_all_clean_seqs_gap0_no20_0.4	ACTCGGGAATGTCCGGTCGTGGTAAGCAGGGTGGCA	12	10	20	18	8	er	independent
seq2270_all_clean_seqs_gap0_no20_0.4	GTGAACTTCCTCCCCCACTGCCTATTTTTACCGCAG	8	6	31	29	23	er	independent
seq2271_all_clean_seqs_gap0_no20_0.4	CTCCTCCCCCACTTCCTATTTTTACCGCAGTTGCAC	14	12	25	23	11	er	cooperative
seq2272_all_clean_seqs_gap0_no20_0.4	CGCCTCATTTCCTGTGCAACTGCGGTAAAAATAGGA	10	8	23	21	13	er	cooperative
seq2274_all_clean_seqs_gap0_no20_0.4	GGTTCGCGGCTTCCGGGACATTTGTACCGCAGGGGG	12	10	27	25	15	er	cooperative
seq2276_all_clean_seqs_gap0_no20_0.4	ACCCCAGGTACCGGAAGACCACAATTCCCAGGAGTC	13	12	19	17	6	er	independent
seq2277_all_clean_seqs_gap0_no20_0.4	TGGTGTGACCAGGATGTGAACCGCGGCAAGCTGCCT	12	11	21	19	9	er	independent
seq2278_all_clean_seqs_gap0_no20_0.4	TCAGGAAGTGGTGTGACCAGCATGTGAACCGCGGCA	4	3	29	27	25	er	cooperative
seq2279_all_clean_seqs_gap0_no20_0.4	GGGCAGGTGCTTCCTTCTCTCAGAAACCACTCCTCC	12	10	27	25	15	er	independent
seq227_all_clean_seqs_gap0_no20_0.4	TTGACTCGGGAATGTCCGGTCGTGGTAAGCAGGGTG	15	13	23	21	8	er	independent
seq2280_all_clean_seqs_gap0_no20_0.4	CAGCTGCCTCCAGGAAGCGGTAAGTGACTCTGGTGG	13	12	18	16	5	er	independent
seq2281_all_clean_seqs_gap0_no20_0.4	ATCACAAGCAGAGGATGTGGTTAGTGTTTCGTTCCA	13	12	18	16	5	er	cooperative
seq2282_all_clean_seqs_gap0_no20_0.4	GCCCTCCGGAGCCGGACGCTGCGGGAGGCCCGGGAG	14	13	22	20	8	er	independent
seq2283_all_clean_seqs_gap0_no20_0.4	CCTCAAGGGTAGGGGAAGTGCGCGGTGAGCGGCCTG	14	13	23	21	9	er	independent
seq2284_all_clean_seqs_gap0_no20_0.4	AAGTTGATTTCCGGGTAGTCTGTGGTTTCCTAATCA	10	8	23	21	13	er	cooperative
seq2285_all_clean_seqs_gap0_no20_0.4	CTGGCTACAGGAAAAACAAAGTCAAACCACAGCACT	10	9	27	25	17	er	cooperative
seq2286_all_clean_seqs_gap0_no20_0.4	CCAGAATGCAGGAAGTGCTGTGGTTTGACTTTGTTT	11	10	21	19	10	er	ambiguous
seq2287_all_clean_seqs_gap0_no20_0.4	AGGGCATAAACAGGATGTGGTGTTGGATGAAACCTT	13	12	18	16	5	er	cooperative
seq2288_all_clean_seqs_gap0_no20_0.4	TCCTTTTCCGGTGGCGGCGCCGCGCGGTGAGGTTGT	7	5	25	23	18	er	independent
seq2289_all_clean_seqs_gap0_no20_0.4	CTGTGAGGCGGAAGTGGCGGGCTCTGTGGGCGCAAG	10	9	27	25	17	er	cooperative
seq228_all_clean_seqs_gap0_no20_0.4	CTGTTTCCGAGTAAAGTAGGGTGTGTGGGTCACATG	6	4	26	24	20	er	ambiguous
seq2290_all_clean_seqs_gap0_no20_0.4	AGGCCCCGCCCCTTCCGCCCACAGAGCCCGCCACTT	14	12	19	17	5	er	independent
seq2291_all_clean_seqs_gap0_no20_0.4	CTTTAAGGAGGCGGAAAAGTTAACCGCGATGGGCAG	13	12	24	22	11	er	cooperative
seq2294_all_clean_seqs_gap0_no20_0.4	CTTCACTATGCATCCTGTACTGCAACCACACCAAAC	13	11	26	24	13	er	independent
seq2295_all_clean_seqs_gap0_no20_0.4	CAGATTCAAGGAAGTGGTGGTGGTTTGGTGTCGTTG	10	9	21	19	11	er	independent
seq2297_all_clean_seqs_gap0_no20_0.4	CTGACAGTTACTTCCTGTCTTTGTGGGCGATTGTGA	13	11	24	22	11	er	independent
seq2298_all_clean_seqs_gap0_no20_0.4	GAGCAAACGGAGGCAGGAAGTGGTTATGTAACTTCA	16	15	21	19	5	er	cooperative
seq2299_all_clean_seqs_gap0_no20_0.4	GCGAGCACTTCCGGTGTGTGAGCCTGCGGTTGCTAC	10	8	27	25	17	er	cooperative
seq229_all_clean_seqs_gap0_no20_0.4	TCTGGCTGGGTGTTGGGATGTGGTTAACCGGGTTGG	16	15	21	19	5	er	cooperative
seq2300_all_clean_seqs_gap0_no20_0.4	TGAAGGGACGGAAGGGACAGAACTTGCGGGAGGCAC	10	9	27	25	17	er	independent
seq2301_all_clean_seqs_gap0_no20_0.4	GGGCGGAAGTGCGTCACTATGTCCGACCCGCAGTGC	5	4	28	26	23	er	independent
seq2302_all_clean_seqs_gap0_no20_0.4	GCCCCAGCCCCCGGATGTGGTGACAGAATCGATACT	13	12	18	16	5	er	cooperative
seq2303_all_clean_seqs_gap0_no20_0.4	TACTACTTACCAGCAGGATGTGGTCCCTGCCCACTG	16	15	21	19	5	er	cooperative
seq2304_all_clean_seqs_gap0_no20_0.4	TGGGGCTCTTCCTGCTTATGTGACCACAGCACCTTG	10	8	24	22	14	er	independent
seq2305_all_clean_seqs_gap0_no20_0.4	ACTTCCAGGAAGCCCCATAGTCCAGAAACCCACACA	8	7	30	28	22	er	independent
seq2307_all_clean_seqs_gap0_no20_0.4	GGACCGGAAGTTAAGGCGTTCGCGGCGTGTGGTAAG	6	5	30	28	24	er	independent
seq2308_all_clean_seqs_gap0_no20_0.4	CCCCGCGGAACTCTGGCACAGTCAGCTGACCGCAGA	7	6	30	28	23	er	cooperative
seq2309_all_clean_seqs_gap0_no20_0.4	GCTTGCTCCCACAGGAAACCGCAGGCTTCGGGCACA	14	13	19	17	5	er	cooperative
seq2310_all_clean_seqs_gap0_no20_0.4	CACGCCTGCGGAAGATGAAAACCACACGTCATGCAG	10	9	22	20	12	er	cooperative
seq2311_all_clean_seqs_gap0_no20_0.4	CTCACAGCAGCCCCAGGAAACCACCTCTTCCTTCAG	16	15	21	19	5	er	independent
seq2313_all_clean_seqs_gap0_no20_0.4	ACATTCTTCCGGTTGGACCTCCGCGGTCAGCGCTGT	8	6	24	22	16	er	cooperative
seq2314_all_clean_seqs_gap0_no20_0.4	GAAAACACAGGAAGCCGTCCGCGCAACCGCGTTGCA	10	9	27	25	17	er	cooperative
seq2315_all_clean_seqs_gap0_no20_0.4	CACCCGAACGGAAACACCTGCGGCTGAGGGGAGGGG	10	9	21	19	11	er	independent
seq2316_all_clean_seqs_gap0_no20_0.4	GGCACCGGAAGTAGAGCTGCCCCTAGTTGCGGCAGT	7	6	30	28	23	er	independent
seq2317_all_clean_seqs_gap0_no20_0.4	GTCGGAAGTGGCCGTGAGCCCAAGCCGCGGTCCCGG	4	3	28	26	24	er	independent
seq2318_all_clean_seqs_gap0_no20_0.4	CGGGTGGTGGCAGGATGTGGGTAGGGGGCCAGGCGA	13	12	18	16	5	er	cooperative
seq2319_all_clean_seqs_gap0_no20_0.4	GGGTGAGTATTTCCTCCTGCGGTGGGTCGGCATGTA	12	10	20	18	8	er	independent
seq231_all_clean_seqs_gap0_no20_0.4	CACCTGCGGAAGTCACAGGGAAGCCACAGAGAGATG	8	7	24	22	16	er	independent
seq2320_all_clean_seqs_gap0_no20_0.4	ACCACGAGCCCAGGATGCGGTTTATGCGCTGTCGGG	13	12	18	16	5	er	cooperative
seq2321_all_clean_seqs_gap0_no20_0.4	CCTTGCTACAGGATGTTTTGACCACGAGCCCAGGAG	11	10	22	20	11	er	cooperative
seq2322_all_clean_seqs_gap0_no20_0.4	ACTGAAAACAGCACAGGATGTGGTCTGCCAGGTGCC	16	15	21	19	5	er	cooperative
seq2324_all_clean_seqs_gap0_no20_0.4	GGAGCATCCCGGAAGTCGTCACTGCGGCCGCTCCCG	11	10	25	23	14	er	cooperative
seq2325_all_clean_seqs_gap0_no20_0.4	AGGGAGACCGGGCCGGATTGCGGGGAGTGAGCAGGT	15	14	21	19	6	er	independent
seq2326_all_clean_seqs_gap0_no20_0.4	GGCGGGACTTCCGGCGTCTCCCCTCGGCGGTTGCTT	10	8	28	26	18	er	independent
seq2327_all_clean_seqs_gap0_no20_0.4	AGCTTGCCGGAAGCTGGTTGTTCGCTGCGGCGACCA	9	8	28	26	19	er	independent
seq2329_all_clean_seqs_gap0_no20_0.4	TCTTCAGGCGTCTTTCCGGTGGTGGTCGTTTTTGCT	15	13	23	21	8	er	independent
seq232_all_clean_seqs_gap0_no20_0.4	GGTCCAGGAAGACGTCAAGGGCTTGGTTTTGTAAAC	7	6	24	22	17	er	independent
seq2330_all_clean_seqs_gap0_no20_0.4	TTACCCCGGCGGAACGGAGGCCTGCGGTCGCGGCGG	11	10	25	23	14	er	cooperative
seq2331_all_clean_seqs_gap0_no20_0.4	GGGGCCTCTGCTACTTCCTAGACCGCAAAATGGAGA	16	14	23	21	7	er	cooperative
seq2332_all_clean_seqs_gap0_no20_0.4	GGGAGGCCCCATCCTGTGTGGCTGTGGCTTTTGCCT	12	10	25	23	13	er	independent
seq2334_all_clean_seqs_gap0_no20_0.4	CTAAGCAGAGGCCGGAAGCGGTGGTTTTTAGCGGCT	14	13	22	20	8	er	independent
seq2335_all_clean_seqs_gap0_no20_0.4	CTGCCCACCGGAAACGATGGCGCGAGGCCGCAGAGC	10	9	28	26	18	er	independent
seq2336_all_clean_seqs_gap0_no20_0.4	GGTGACACGGCCGGCTTCCTGCCGCAGAGCTCCTGG	17	15	22	20	5	er	independent
seq2337_all_clean_seqs_gap0_no20_0.4	GACATCCAGGAAGTGGTGAGAAACCACGTGTGTGTT	9	8	24	22	15	er	cooperative
seq2338_all_clean_seqs_gap0_no20_0.4	CCCAAGCTACGGAAGTTAAACCTCAAACATGAAATC	11	10	21	19	10	er	independent
seq2339_all_clean_seqs_gap0_no20_0.4	GCTAAAGGAAGCTCTGTACAGCTGTGGTAAGGTGGC	7	6	25	23	18	er	independent
seq233_all_clean_seqs_gap0_no20_0.4	TCCTGTAGTTTCCGGCTGAAGTGGTAAGGTTTTTGA	11	9	22	20	11	er	independent
seq2340_all_clean_seqs_gap0_no20_0.4	CGTACGCGCACTTCCGGTCTTTGTGGCTTGCAGCTC	13	11	24	22	11	er	independent
seq2341_all_clean_seqs_gap0_no20_0.4	GCTCATTTCCTGGCCGCTCCTGGGCTTCGCGGTGAG	8	6	30	28	22	er	cooperative
seq2342_all_clean_seqs_gap0_no20_0.4	GGCGCGGGCTGCTTCCGGTCTGCGGGCCTGAGGAGG	14	12	23	21	9	er	independent
seq2344_all_clean_seqs_gap0_no20_0.4	CTCGGAGCGGAACTACTAGGGTGGTTTCTCCTGAGG	9	8	22	20	13	er	independent
seq2346_all_clean_seqs_gap0_no20_0.4	CTGAGCCGGATGTTACTGGTTAGTGGTTTTCTTTAT	8	7	24	22	16	er	cooperative
seq2347_all_clean_seqs_gap0_no20_0.4	GCTGCCACTTCCCTTGCTTATTTCATGTGGTTTGGA	10	8	28	26	18	er	independent
seq2348_all_clean_seqs_gap0_no20_0.4	TGTCAGCTGCGTTTCCGCGGTCGCGGGTGAGTGTGC	14	12	18	16	4	er	ambiguous
seq2349_all_clean_seqs_gap0_no20_0.4	ACTAGAAGCGGAAGTAGTTGTGGGCGCCTTTGCAAC	10	9	21	19	11	er	independent
seq234_all_clean_seqs_gap0_no20_0.4	CCGACCTTAACGACATCCTGCGGCTCAGCGTGGAGG	16	14	21	19	5	er	independent
seq2350_all_clean_seqs_gap0_no20_0.4	ACCCTGAAATTACCCGGATGTGGTCCCCGCGCGCGC	16	15	21	19	5	er	independent
seq2351_all_clean_seqs_gap0_no20_0.4	CGGAGGCGGCCGGAAGTAGCGCTGCGGTTGGCAGCT	12	11	25	23	13	er	cooperative
seq2352_all_clean_seqs_gap0_no20_0.4	ACGCTGGAATCGCGGAAACCGCCGGTGCACGTTGGA	14	13	19	17	5	er	independent
seq2353_all_clean_seqs_gap0_no20_0.4	CTGAAACAGGAAGCTGAGGGTGCGGTTGGGGGAGGA	9	8	23	21	14	er	cooperative
seq2354_all_clean_seqs_gap0_no20_0.4	CTCTCGGCGGCTTCCGTGCGGTCCTAAAGGCTGGTG	13	11	19	17	6	er	independent
seq2355_all_clean_seqs_gap0_no20_0.4	CTGAAGAGGAAATGTATTCCTCATGTTGTGGTTGGC	8	7	29	27	21	er	cooperative
seq2356_all_clean_seqs_gap0_no20_0.4	TTCAACAAGGTTTTCCTGTGGTTACCCCATGCTTTG	14	12	19	17	5	er	ambiguous
seq2357_all_clean_seqs_gap0_no20_0.4	GTTGGGCTTTGAGGATGTGGGTTCTAGAAGTTTACA	13	12	18	16	5	er	cooperative
seq2358_all_clean_seqs_gap0_no20_0.4	GGGAGGTCACATCCTGCCCGCGGTCTCAGAAAAGCT	12	10	21	19	9	er	independent
seq2359_all_clean_seqs_gap0_no20_0.4	TTGCAGCCACGGCTTCCTCCTGCGGCGAATCTGCCG	15	13	23	21	8	er	independent
seq2360_all_clean_seqs_gap0_no20_0.4	GGCTTGATTGAACGAGGATGTGGTTCTTGGGTGGGA	16	15	21	19	5	er	cooperative
seq2361_all_clean_seqs_gap0_no20_0.4	GGGAACTCACACCGGAAACCACAGAACCAAGAGTGG	14	13	19	17	5	er	cooperative
seq2362_all_clean_seqs_gap0_no20_0.4	GCACACCGGAACTCACACCTGAAACCACAGAACCAA	8	7	25	23	17	er	cooperative
seq2363_all_clean_seqs_gap0_no20_0.4	CTCCGGCGGAAGTTGTCTCTTCGCCGCCGCCGCAGC	8	7	30	28	22	er	independent
seq2364_all_clean_seqs_gap0_no20_0.4	CCCCTCTCTCCCACTTCCTGTGGTCTCAGTCTTTGT	16	14	21	19	5	er	independent
seq2365_all_clean_seqs_gap0_no20_0.4	GACTTCCTGTTGAAGATTGGCCTCTGCGGTACCACG	5	3	27	25	22	er	independent
seq2366_all_clean_seqs_gap0_no20_0.4	CTTTGTTGAAAAGGATGTGGTCATCTGATCTTGCTG	13	12	18	16	5	er	cooperative
seq2367_all_clean_seqs_gap0_no20_0.4	GAGTGGGCGGAAATCCGTGCCTGGCAGACCACAAAG	9	8	29	27	20	er	cooperative
seq2368_all_clean_seqs_gap0_no20_0.4	AGGTGTACTTTCCGGGTGCAGACCGCGAATGGATCG	11	9	23	21	12	er	independent
seq2370_all_clean_seqs_gap0_no20_0.4	CTCCGGGAACAGCGGAAAAGGGACCGCATGAACCTC	14	13	24	22	10	er	cooperative
seq2371_all_clean_seqs_gap0_no20_0.4	GCCAGGGCAGGAAGTTGCTAACCGCCCCAGAGCAGG	10	9	22	20	12	er	independent
seq2373_all_clean_seqs_gap0_no20_0.4	GCGACCCGACCCGGCGGAAACCACCTCGACAGCCTC	16	15	21	19	5	er	independent
seq2375_all_clean_seqs_gap0_no20_0.4	TATTTCCTGTGCACAGAAGCAGCTGGGCCGCAGAGT	5	3	28	26	23	er	cooperative
seq2376_all_clean_seqs_gap0_no20_0.4	GACATGCTCCGGAAGCTTGAGGTTTTAACGTTAAGG	11	10	20	18	9	er	independent
seq2377_all_clean_seqs_gap0_no20_0.4	CGACGTCACTTCCGCTGGTTCAAGCACCGCGAGACT	11	9	27	25	16	er	independent
seq2378_all_clean_seqs_gap0_no20_0.4	GCCACACAGGCAGGAAAGCCACAGCCCACGTCTCCG	13	12	19	17	6	er	independent
seq2379_all_clean_seqs_gap0_no20_0.4	GATACCTAGAAGCCAGGAAACCGCGAGCTGCAGTCC	16	15	21	19	5	er	cooperative
seq237_all_clean_seqs_gap0_no20_0.4	ACTACAGGAGGAAACTACAGCCTAAACCACATGCAA	10	9	27	25	17	er	independent
seq2380_all_clean_seqs_gap0_no20_0.4	GGCGGCACTAGGCTTCCGCCTCACCGCAGTGGGGTT	15	13	24	22	9	er	cooperative
seq2382_all_clean_seqs_gap0_no20_0.4	CTTACCTACAGTTCCGCTTGCTGTGGTTTCAGTTAC	13	11	24	22	11	er	cooperative
seq2383_all_clean_seqs_gap0_no20_0.4	GGCCGACGGGAAGTGTAGTCCGGCCTGCGGTCCGGG	9	8	28	26	19	er	cooperative
seq2384_all_clean_seqs_gap0_no20_0.4	GGCTTCCGCCTGCCGAGCGGCCCCGGACCGCAGGCC	5	3	28	26	23	er	independent
seq2385_all_clean_seqs_gap0_no20_0.4	CCAGACCCGGCGGAACTACCGTGCCCACAAGGCAGC	12	11	25	23	13	er	independent
seq2386_all_clean_seqs_gap0_no20_0.4	CGGGGCTTCCGGCGCGCTGCCTTGTGGGCACGGTAG	8	6	25	23	17	er	independent
seq2389_all_clean_seqs_gap0_no20_0.4	GTGGAAAGGAAATGTGTCATCTGTGGTTTGGTTTTA	8	7	24	22	16	er	cooperative
seq238_all_clean_seqs_gap0_no20_0.4	AAACTACTTTCCTTCCTACCAAAACCACACTAAAGA	14	12	25	23	11	er	independent
seq2391_all_clean_seqs_gap0_no20_0.4	TGAAGCCATGGTTTCCTGTCTGCGGCTCAGATCAAG	14	12	23	21	9	er	independent
seq2392_all_clean_seqs_gap0_no20_0.4	TCAAGTTTGGTAACAGGATGTGGTAGGAGGAACACA	16	15	21	19	5	er	cooperative
seq2394_all_clean_seqs_gap0_no20_0.4	TCCGGAAATAGATAATATCTAGTTAAACCTCAAAAT	4	3	28	26	24	er	cooperative
seq2397_all_clean_seqs_gap0_no20_0.4	AGAAGCTGCACCCGGAAATGAAACCACCAGGACCTC	14	13	24	22	10	er	independent
seq2398_all_clean_seqs_gap0_no20_0.4	TCTAGTTCTGGTTTCCGGACCGCATTCGGAACTAGA	14	12	20	18	6	er	independent
seq2399_all_clean_seqs_gap0_no20_0.4	CCCTCCTCTTTCGTTTCCTAACCGCAAATTCCATCA	16	14	22	20	6	er	cooperative
seq239_all_clean_seqs_gap0_no20_0.4	CCAAAAAGGAAGGAAACCAGAAAGCCACAGAATGGT	8	7	25	23	17	er	cooperative
seq2400_all_clean_seqs_gap0_no20_0.4	GTGCGGAAGCGCGCCAAGGCACGTGACCGCTTCTGT	5	4	27	25	22	er	cooperative
seq2401_all_clean_seqs_gap0_no20_0.4	GCGCGCTTCCGCCTTCATGCTAGCAACGCCCGCAGT	8	6	30	28	22	er	independent
seq2402_all_clean_seqs_gap0_no20_0.4	GTTAGAGGAAGAGGAAGCGGTCAAGAGATCGTCACA	13	12	18	16	5	er	cooperative
seq2403_all_clean_seqs_gap0_no20_0.4	TCTGGGGGAGGGGAAGGATGTGGTTTGCAGAGCGGA	16	15	21	19	5	er	cooperative
seq2404_all_clean_seqs_gap0_no20_0.4	CTGCCTGGCACAGGATGTGGTCATTTGTGCTGAGGA	13	12	18	16	5	er	cooperative
seq2405_all_clean_seqs_gap0_no20_0.4	CCACGTAAAGGCGGAAGCGGTTGAGTGGACGCCATC	13	12	18	16	5	er	cooperative
seq2406_all_clean_seqs_gap0_no20_0.4	TGGCTGTCACTTCCTGTCCCACTGTGGTTCCTGGGA	12	10	25	23	13	er	independent
seq2407_all_clean_seqs_gap0_no20_0.4	CCCCACCCAGACAGGAAACTGTGGCTTCTATCAGAT	14	13	22	20	8	er	independent
seq2408_all_clean_seqs_gap0_no20_0.4	AAATACCAGCCCACTTCCTGTGGCTTTGATCTGCAG	16	14	21	19	5	er	cooperative
seq2409_all_clean_seqs_gap0_no20_0.4	AGCTCAATTTCCTGGCGTGTAACATGGCCACAAGGG	10	8	28	26	18	er	independent
seq2410_all_clean_seqs_gap0_no20_0.4	TGACTAAGACCGGAAGAAACCACAAAAACACAAAAA	12	11	20	18	8	er	independent
seq2411_all_clean_seqs_gap0_no20_0.4	AGCTTGCGCAGGAAGTCTGCGGCAGGAGGGCGTCCT	11	10	20	18	9	er	independent
seq2412_all_clean_seqs_gap0_no20_0.4	TCCCTCATGAGCTTCTTCCGCCCGCAACACGAGACT	17	15	22	20	5	er	independent
seq2413_all_clean_seqs_gap0_no20_0.4	TTACACAACAGGAAACTATGTTTAGCGGTTAATCCA	11	10	26	24	15	er	cooperative
seq2414_all_clean_seqs_gap0_no20_0.4	GGGGAGGACGCGGAAGAGGAGCTGTGGGAAGGGGGA	12	11	25	23	13	er	independent
seq2415_all_clean_seqs_gap0_no20_0.4	GGCCGGGGGCAGGAAGCTGCGGCGCTGGCTCCCCCC	12	11	20	18	8	er	independent
seq2416_all_clean_seqs_gap0_no20_0.4	AACTGCCTGGTGGCCGGAAACCGCTGGAGGGAGGGC	16	15	21	19	5	er	ambiguous
seq2417_all_clean_seqs_gap0_no20_0.4	CACCTGGCCCGGACGGCTGCGGTCTGGAGGGCTGTC	11	10	20	18	9	er	cooperative
seq2418_all_clean_seqs_gap0_no20_0.4	GCCATTAAAGCAGCTTCCTGTGGGCGCGGCGCAGGA	16	14	21	19	5	er	independent
seq2419_all_clean_seqs_gap0_no20_0.4	GCGCAGGTCCCGGATGTTGCGGACAGTATGAGGCAA	12	11	20	18	8	er	independent
seq2421_all_clean_seqs_gap0_no20_0.4	ACTATTTTTAGACTTCCCCACCCCGCAGTTTCAAGG	15	13	23	21	8	er	independent
seq2422_all_clean_seqs_gap0_no20_0.4	CAACCTGCTATAAGGAAGTTAAACCGCAGCTCACCG	14	13	24	22	10	er	cooperative
seq2423_all_clean_seqs_gap0_no20_0.4	GCTCTGGCGGAAGATGTCCCTGCGGTGCAGCTGCCG	9	8	23	21	14	er	independent
seq2424_all_clean_seqs_gap0_no20_0.4	ACCCTTCCTGGAGCATTGTCGCAGCAACCACAACAG	6	4	28	26	22	er	cooperative
seq2425_all_clean_seqs_gap0_no20_0.4	CTCTTCAGCAGGAAATGATGTGGTAAAACAGGGTTA	11	10	21	19	10	er	cooperative
seq2426_all_clean_seqs_gap0_no20_0.4	CGAGCTATTTACTTCCTGCGGGTGCACAGGCTGTGA	14	12	19	17	5	er	independent
seq2427_all_clean_seqs_gap0_no20_0.4	TAAAGCGGAAGGGGCCGGCTCTGCGGCCTGGCCGCT	7	6	24	22	17	er	cooperative
seq2428_all_clean_seqs_gap0_no20_0.4	ACATTTCCTTTTGGTATTTAAAGTAACCACACAGAA	6	4	27	25	21	er	cooperative
seq2429_all_clean_seqs_gap0_no20_0.4	TTCTTCCGGCAACTGCTGCTGAGGCTGCGGTGGCGG	5	3	28	26	23	er	cooperative
seq242_all_clean_seqs_gap0_no20_0.4	TTAGATGTGCCTACATCCTGACCTCAAAAACCTCTG	16	14	22	20	6	er	independent
seq2430_all_clean_seqs_gap0_no20_0.4	ACAGGAAATGACTTAGGGAAAGTCCCAACCGCAATC	4	3	29	27	25	er	cooperative
seq2432_all_clean_seqs_gap0_no20_0.4	GGCCGGGGACGGAAGGCGGGCCCGCAGCAGATCCTG	11	10	22	20	11	er	independent
seq2434_all_clean_seqs_gap0_no20_0.4	TCTTGTTTCTTCCGTTACCGGAGCGCGGTCACGTGA	11	9	26	24	15	er	independent
seq2435_all_clean_seqs_gap0_no20_0.4	CGTGGCGGAAGCCGCGGGGACTGCGGGGGCGGAGTG	7	6	24	22	17	er	independent
seq2436_all_clean_seqs_gap0_no20_0.4	ATTCCTAGAGAGGAAATGCGGGCTCAGGGTGTCGGC	12	11	19	17	7	er	independent
seq2438_all_clean_seqs_gap0_no20_0.4	GAGTACAGGAAATGCAAAGTAAAACCACAGTGAGAT	8	7	25	23	17	er	cooperative
seq2439_all_clean_seqs_gap0_no20_0.4	AAACTACACCTCAGAGGATGTGGTTCCTTCTCTCAT	16	15	21	19	5	er	independent
seq243_all_clean_seqs_gap0_no20_0.4	GACGGGATGTAGGTTTTCAGCCGTGGCCACAGGAGA	5	4	27	25	22	er	independent
seq2440_all_clean_seqs_gap0_no20_0.4	AGCTCCACCGGAAACGGCCTGGCCGCAGCCAATCAG	10	9	23	21	13	er	cooperative
seq2441_all_clean_seqs_gap0_no20_0.4	AGGGAAGCAGGAAGTGACTGCGGGAGTGGAGCCGGC	10	9	21	19	11	er	independent
seq2442_all_clean_seqs_gap0_no20_0.4	GCAGGGGCCCATTTCCTGCCACAAGCCCACACAGGA	14	12	19	17	5	er	independent
seq2443_all_clean_seqs_gap0_no20_0.4	TGCTTCCGGCGGGCGCTTGCTCCCCGCGGTCCGCAC	5	3	27	25	22	er	independent
seq2444_all_clean_seqs_gap0_no20_0.4	AGGGAAGCGGCGGCGGAAGCCCCGCAGGAGGCCGGC	15	14	22	20	7	er	independent
seq2445_all_clean_seqs_gap0_no20_0.4	GCACTTCCGGAGCCGGGCGTCTACAGACCGCGGCCA	6	4	28	26	22	er	cooperative
seq2446_all_clean_seqs_gap0_no20_0.4	ATGTGCGTGTGCACAGGAAAACCACTGCCAGTATTT	16	15	22	20	6	er	independent
seq2447_all_clean_seqs_gap0_no20_0.4	GCGGGAAAAGGGAAGTTTGCGGGAGGTCAAATCCAC	11	10	20	18	9	er	independent
seq2448_all_clean_seqs_gap0_no20_0.4	TGCACTCCACTTCCCCTCGCCCGCAGTGAGCAGTCA	12	10	21	19	9	er	independent
seq2449_all_clean_seqs_gap0_no20_0.4	GTGGGTAGGGAGGAAGCTGTGAAACCACCTCCCCTC	12	11	25	23	13	er	independent
seq244_all_clean_seqs_gap0_no20_0.4	GTGCCACTGAGAGGAAGGGGGCAACCACAGTGGGAG	13	12	25	23	12	er	cooperative
seq2450_all_clean_seqs_gap0_no20_0.4	CTGCACAAGGAAGCGCCTGTGTTGCTGTGGGCGGAG	9	8	28	26	19	er	independent
seq2451_all_clean_seqs_gap0_no20_0.4	TCAGAGACTTCCGCTCAGCAGCAGCTGCGGCCAGGC	10	8	28	26	18	er	independent
seq2452_all_clean_seqs_gap0_no20_0.4	TGCCTCCTCGTCACAGGATGTGGTCGCTGCACCCTG	16	15	21	19	5	er	cooperative
seq2453_all_clean_seqs_gap0_no20_0.4	ACAGGAAGTCAGCTGAGTACCGAGCAAGCCGCATGC	4	3	29	27	25	er	independent
seq2455_all_clean_seqs_gap0_no20_0.4	CGAAACGCGTTCCCCGGAAACCGCGCCCGGCTCCGA	16	15	21	19	5	er	independent
seq2456_all_clean_seqs_gap0_no20_0.4	ACACAGGAAGGACGCACGCTCCCGCCCCAACCACAT	6	5	31	29	25	er	independent
seq2457_all_clean_seqs_gap0_no20_0.4	GCACCGTCTACCCGGAAGTTGTGGGCTGGGAGGGAT	14	13	22	20	8	er	cooperative
seq2458_all_clean_seqs_gap0_no20_0.4	TGCAGTCGTGAAAAAGGAAGTGGTTAAAGTGGATAC	16	15	21	19	5	er	cooperative
seq2459_all_clean_seqs_gap0_no20_0.4	GTGCAGACAGGAAATAGCTGCTCTGCGGCAGCCCGA	10	9	26	24	16	er	independent
seq245_all_clean_seqs_gap0_no20_0.4	ACAGCATTTCCTGGTGGCCAGATATCTGAGGTTTCA	9	7	29	27	20	er	independent
seq2460_all_clean_seqs_gap0_no20_0.4	TGCCCTGACTTCCTGGTCCTGTGGTCAAGGATGGGG	11	9	22	20	11	er	ambiguous
seq2461_all_clean_seqs_gap0_no20_0.4	GGCAGGAGCTTCCGGCTCAGCCCTGCGGCCTGTGCC	11	9	26	24	15	er	independent
seq2464_all_clean_seqs_gap0_no20_0.4	CCGGGCGCCACTTCCGGTCCCCGTGGTCACGTGACC	13	11	24	22	11	er	independent
seq2465_all_clean_seqs_gap0_no20_0.4	CTACTTTCCGGTCAACGCGGCCTGCGGTACCACCTC	7	5	25	23	18	er	cooperative
seq2468_all_clean_seqs_gap0_no20_0.4	GTGGGGAGAGGCAGGAAACCGCTGCCGCCGACGGGG	14	13	19	17	5	er	independent
seq246_all_clean_seqs_gap0_no20_0.4	TTCATAAAGGAGAGGAAACCTGACCACGACAGAAAG	14	13	24	22	10	er	independent
seq2470_all_clean_seqs_gap0_no20_0.4	GGACGCTTCCGGTGGAAGGGAGCTGTTGCGGGGCTT	8	6	29	27	21	er	independent
seq2471_all_clean_seqs_gap0_no20_0.4	ATTACATCCGGGCTCCGCGACACGCCCGAACCACAA	7	5	31	29	24	er	ambiguous
seq2472_all_clean_seqs_gap0_no20_0.4	TGCCGCGGATACCCAGCCAGCGGCAGTGCGGTTAAC	7	6	29	27	22	er	cooperative
seq2473_all_clean_seqs_gap0_no20_0.4	GATACCCAGCCAGCGGAAGTGCGGTTAACTGCCCGA	15	14	22	20	7	er	cooperative
seq2474_all_clean_seqs_gap0_no20_0.4	ACCGGCCGAGCCAACTTCCGGCCGCAGAGGCTGCCG	17	15	22	20	5	er	independent
seq2476_all_clean_seqs_gap0_no20_0.4	GTGCAGGGCCCGGAAGCTCAGTGTGGTTAAAGACAT	12	11	24	22	12	er	cooperative
seq2477_all_clean_seqs_gap0_no20_0.4	TTCTATCCTGCCTTGCATGTCTTTAACCACACTGAG	6	4	27	25	21	er	ambiguous
seq2478_all_clean_seqs_gap0_no20_0.4	CTGGTTTCCAACATCCTGTGGGCGGCCTGGTTTCAG	14	12	19	17	5	er	ambiguous
seq2479_all_clean_seqs_gap0_no20_0.4	GTGACGGATATCCACCGGGCCCTGTGGTTTCCAACA	6	5	25	23	19	er	cooperative
seq247_all_clean_seqs_gap0_no20_0.4	GTGTTTCCTCTTTGTTTTGGGGCTGTGGTTGCCACA	6	4	26	24	20	er	cooperative
seq2480_all_clean_seqs_gap0_no20_0.4	CACCCATAGCACCCCGGAAACCACCTCCACCACCTG	16	15	21	19	5	er	independent
seq2481_all_clean_seqs_gap0_no20_0.4	TGGCTACCCGGAAGGCGCGTTGGCTGCGGCTACGCA	10	9	27	25	17	er	cooperative
seq2482_all_clean_seqs_gap0_no20_0.4	ATGTACATAGATACAGGATGTGGGTTTGTTACAAAG	16	15	21	19	5	er	cooperative
seq2483_all_clean_seqs_gap0_no20_0.4	ATGCTAGAAAGCAGGAAGCCACAGACACGCCCCAAC	14	13	19	17	5	er	independent
seq2484_all_clean_seqs_gap0_no20_0.4	GAAATGAAGGCCGGATGTCAGTAACCACAAACGAGC	13	12	25	23	12	er	cooperative
seq2485_all_clean_seqs_gap0_no20_0.4	GTTCTTATCCTGTGGCTCGTTTGTGGTTACTGACAT	8	6	24	22	16	er	cooperative
seq2486_all_clean_seqs_gap0_no20_0.4	TGTCGTACATTTCCGCCTTGTGGGCACAATCTGATT	12	10	21	19	9	er	cooperative
seq2487_all_clean_seqs_gap0_no20_0.4	GTACGACAGCGGGTTCCGGTGACCACGAAGGCGGCA	15	13	23	21	8	er	independent
seq2489_all_clean_seqs_gap0_no20_0.4	TACAGCCAGGAAATGGGGAGGGTGCTGCGGGCGGCA	9	8	28	26	19	er	cooperative
seq248_all_clean_seqs_gap0_no20_0.4	GCACTGGAGGAAACTGCTCTCCCTTGCGGCTGGACG	9	8	27	25	18	er	independent
seq2490_all_clean_seqs_gap0_no20_0.4	GGGTCGCGGCCTTCCGGCGAACGCGGTTACCGTGGA	13	11	24	22	11	er	cooperative
seq2491_all_clean_seqs_gap0_no20_0.4	AATCTGAAACAGGAAATAAGTCTGTGGTTGTGTGTT	12	11	25	23	13	er	cooperative
seq2492_all_clean_seqs_gap0_no20_0.4	CTCTGAACTTCCTCTCTTTTAACCACAACTTACTAC	10	8	23	21	13	er	cooperative
seq2493_all_clean_seqs_gap0_no20_0.4	GGCCTTCATTACACAGGATGCGGTTGAAATGCATCA	16	15	21	19	5	er	cooperative
seq2494_all_clean_seqs_gap0_no20_0.4	GGCAGGAAAGAGCTGATGCATTTCAACCGCAGCCTG	5	4	27	25	22	er	cooperative
seq2495_all_clean_seqs_gap0_no20_0.4	GACAGGAAGCCCGCGGCAGCCTCCGTGGTTGCAGAT	5	4	26	24	21	er	independent
seq2496_all_clean_seqs_gap0_no20_0.4	CGGGGATGGGATTTCCGGTGGTTTTTCTTCACTTTC	14	12	19	17	5	er	independent
seq2497_all_clean_seqs_gap0_no20_0.4	GGAGGAAGAGGAGGATGTGGTGAGCCGCTCCCCGCC	13	12	18	16	5	er	cooperative
seq2498_all_clean_seqs_gap0_no20_0.4	TGGCTGCCACTGAGAGGATGTGGTGACAGAGGTGGG	16	15	21	19	5	er	cooperative
seq2499_all_clean_seqs_gap0_no20_0.4	GCACTCATTTCCTGTCCCCTGTGGTTTAAAGGTTTT	10	8	22	20	12	er	cooperative
seq249_all_clean_seqs_gap0_no20_0.4	CGAAGAGGAAGCCCCTGTATCACCCCACAAGAAGCC	7	6	25	23	18	er	independent
seq24_all_clean_seqs_gap0_no20_0.4	CTGGGGATGTGTGACACTCAGAGAAACCACAAGGTG	5	4	27	25	22	er	cooperative
seq2501_all_clean_seqs_gap0_no20_0.4	AGGTACCAGGCCCGGAAACCACGGAAAGGGGAACTT	14	13	19	17	5	er	independent
seq2502_all_clean_seqs_gap0_no20_0.4	GCTTACACTTCCTCCCTGAACCCCTGCGGTTTCACA	10	8	27	25	17	er	cooperative
seq2503_all_clean_seqs_gap0_no20_0.4	AGCGCCGGAAGTGTGTCTGCGTAAAACTGCGGCTCG	7	6	30	28	23	er	independent
seq2504_all_clean_seqs_gap0_no20_0.4	ACTACAACTTCCGACTTGCATCACTGCGGTGGCGCT	10	8	27	25	17	er	independent
seq2505_all_clean_seqs_gap0_no20_0.4	ACTGAACAAACCGGATGTGGTTGCCACCTGCAATCT	13	12	18	16	5	er	cooperative
seq2506_all_clean_seqs_gap0_no20_0.4	GCAGCTTCCGCGGCCCCCGCCCGGCCCGCAGCGCCA	7	5	26	24	19	er	ambiguous
seq2507_all_clean_seqs_gap0_no20_0.4	GCGCGGCCCGGAAGGGGGTAACCGCTGAGTCTTTGA	10	9	22	20	12	er	cooperative
seq2508_all_clean_seqs_gap0_no20_0.4	AGGGTTGGGGAGGATGTTGTGGTTATTATTGACATA	12	11	20	18	8	er	cooperative
seq2509_all_clean_seqs_gap0_no20_0.4	GGACTCTGGCAGGAAGCTGTTTGTGGTTGTCACACC	12	11	24	22	12	er	cooperative
seq250_all_clean_seqs_gap0_no20_0.4	GGGTGCAGCAGGAAGGTTGAGGTCAGATCCTCCCAG	11	10	20	18	9	er	independent
seq2510_all_clean_seqs_gap0_no20_0.4	CTGCCTTTCCTGCTAGGGTACAAACCACAGCCTTAG	8	6	25	23	17	er	cooperative
seq2511_all_clean_seqs_gap0_no20_0.4	CTACAACTCCCAGGATGCACCGCGGCGACACCCGCC	13	12	20	18	7	er	ambiguous
seq2512_all_clean_seqs_gap0_no20_0.4	CAGTTCCAGGAAGCAGCCCCAAGCTTGTGGCCCTGA	9	8	28	26	19	er	ambiguous
seq2513_all_clean_seqs_gap0_no20_0.4	CTGCGAGCTCAGAACGGAAACCACAGCAACTACCGT	16	15	21	19	5	er	cooperative
seq2514_all_clean_seqs_gap0_no20_0.4	GATCTGCTTGGCTTCCTGTGGTCGCTGACTCACAGT	14	12	19	17	5	er	cooperative
seq2517_all_clean_seqs_gap0_no20_0.4	TGAGGCTCAGAGGAAGTGACTGGCCCGCAGGGTCAC	12	11	25	23	13	er	independent
seq2518_all_clean_seqs_gap0_no20_0.4	TGCGCCGGAAGTGCATGAGCTGCCGATGTGGTGCTT	7	6	29	27	22	er	independent
seq251_all_clean_seqs_gap0_no20_0.4	CTCTTCTCAGGAAGGGGCTGTGGGATGTAGGATTCC	10	9	21	19	11	er	independent
seq2520_all_clean_seqs_gap0_no20_0.4	TGGGGGCGGAAGCCTAAACCCCTCCCGCAGCCAGTC	8	7	25	23	17	er	independent
seq2521_all_clean_seqs_gap0_no20_0.4	CGGCCTCTTCCGGTCACCTGGCCCGTCGCGGTCCCG	9	7	29	27	20	er	independent
seq2523_all_clean_seqs_gap0_no20_0.4	TTCTCATCCGGCCGGCTTGCTTTCCCCTGCGGTCGT	7	5	30	28	23	er	cooperative
seq2524_all_clean_seqs_gap0_no20_0.4	TGGGCAGGAAGTGGTATCTGATTGTGGTTTTGATTT	7	6	25	23	18	er	cooperative
seq2526_all_clean_seqs_gap0_no20_0.4	TCATGCTGCTTCCTGCCCAACCCGCAGTTCCGATAA	11	9	22	20	11	er	cooperative
seq2528_all_clean_seqs_gap0_no20_0.4	GAAGGTTGTAGAGGAAGTGGTTTGTTCTTCCTCCTG	13	12	18	16	5	er	independent
seq2529_all_clean_seqs_gap0_no20_0.4	TCCTAAAGCAGGAAATAGTGAGGCTACCGCAGTGTC	11	10	27	25	16	er	cooperative
seq252_all_clean_seqs_gap0_no20_0.4	CTAACCCTGCTTCCTCTTAGTGGTTTCCCCCAACCT	12	10	21	19	9	er	cooperative
seq2531_all_clean_seqs_gap0_no20_0.4	TTCATCTCTCACTTCCTGTGGTGACGGCTGACGGGG	14	12	19	17	5	er	independent
seq2533_all_clean_seqs_gap0_no20_0.4	CCCAGCCGAGGGAGGAAGCCTGCGGTCACTGCCATC	14	13	23	21	9	er	cooperative
seq2534_all_clean_seqs_gap0_no20_0.4	CTGCTTCGGCCCGGCTTCCGCCCACAGTCAACTGCC	17	15	22	20	5	er	independent
seq2535_all_clean_seqs_gap0_no20_0.4	AGCACGTCCCCCTTCTTCCTCCCGCAGAGGGCCTGC	17	15	22	20	5	er	independent
seq2536_all_clean_seqs_gap0_no20_0.4	TGCAATTGGCAGACAGGAAACCGCGGCGTTTTCTGG	16	15	21	19	5	er	cooperative
seq2537_all_clean_seqs_gap0_no20_0.4	GCGCCCTCCAGGAAACGCCGCGGTTTACTGTCTGCC	11	10	21	19	10	er	cooperative
seq2539_all_clean_seqs_gap0_no20_0.4	GCGCCATTTCCGCTGCGCAAGGCACCACAGGCCCTG	9	7	25	23	16	er	independent
seq253_all_clean_seqs_gap0_no20_0.4	GGGGAAAGGAAGAGGAAACCGCGAGTGCAAAGGCCC	14	13	19	17	5	er	cooperative
seq2540_all_clean_seqs_gap0_no20_0.4	ACTGACATAATATAAGGAAGCCACAAGGGCCAATGC	16	15	21	19	5	er	independent
seq2541_all_clean_seqs_gap0_no20_0.4	GGTTTCACTTCCTGCGTTGGGCCTTGTGGCCTCCTT	10	8	27	25	17	er	independent
seq2544_all_clean_seqs_gap0_no20_0.4	CAGCTTCCGGGCTAATTAGCAGTCGCGGTGTGCCGC	6	4	26	24	20	er	independent
seq2545_all_clean_seqs_gap0_no20_0.4	AGACCCGGACCGGAACCTTGGCGCGGTGACGCTAGT	12	11	24	22	12	er	independent
seq2546_all_clean_seqs_gap0_no20_0.4	AGCCCGCCGGAAACTAGCGTCACCGCGCCAAGGTTC	9	8	23	21	14	er	independent
seq2547_all_clean_seqs_gap0_no20_0.4	TGAGTCATTTCCTGGGTGGGGGCCACAAGACCAGGT	10	8	23	21	13	er	independent
seq2548_all_clean_seqs_gap0_no20_0.4	GAAGGGGAAGTCCAGGAGCATGGGTGGTTTTTTTCC	6	5	25	23	19	er	ambiguous
seq2550_all_clean_seqs_gap0_no20_0.4	CGAGCTCGGTGTTCCGCTTTTTGTGGGCCGGGTGGG	13	11	24	22	11	er	independent
seq2551_all_clean_seqs_gap0_no20_0.4	TGCCTCACCTCACATCCGTTTGTGGCTGCCGAGTGC	15	13	23	21	8	er	independent
seq2552_all_clean_seqs_gap0_no20_0.4	AATTCCCAGGAAGCACTCGGCAGCCACAAACTGATG	9	8	24	22	15	er	independent
seq2553_all_clean_seqs_gap0_no20_0.4	CCCATTTCCTGCTCTCCAGAGTTAACCACTGAAGTC	7	5	26	24	19	er	cooperative
seq2554_all_clean_seqs_gap0_no20_0.4	CCTCGGTTCGGAAACGGCGAAAGCAAACCGCAAGGA	10	9	28	26	18	er	cooperative
seq2555_all_clean_seqs_gap0_no20_0.4	CGCCGGCTCCCGGATGTTGTGGGGATCAGCGCCCGC	12	11	20	18	8	er	independent
seq2556_all_clean_seqs_gap0_no20_0.4	ACAAGAGGAAGTGAGTCTACCCATGATGCGGTCACA	7	6	29	27	22	er	cooperative
seq2557_all_clean_seqs_gap0_no20_0.4	CACTTCCGGGTCGTCAGCTCAGTTCTGCGGTTTCTG	5	3	28	26	23	er	cooperative
seq2558_all_clean_seqs_gap0_no20_0.4	TGGAGTGGAGGAAGTGGTGTTACCACAGCTCAGAGG	10	9	23	21	13	er	cooperative
seq255_all_clean_seqs_gap0_no20_0.4	GATGGTGTCTTTTGGGGATGTGGGTTTGGGGGATGG	16	15	21	19	5	er	cooperative
seq2560_all_clean_seqs_gap0_no20_0.4	ATCTTGGCCCATATCCTGTGGTGTTCTGCTAGAGGT	14	12	19	17	5	er	independent
seq2561_all_clean_seqs_gap0_no20_0.4	CTCTTCCTGCCTGTCCGTGGCTGGTGTGGTTTGCGT	5	3	27	25	22	er	independent
seq2562_all_clean_seqs_gap0_no20_0.4	GCTGAGGCCGGAAGAGGGTGGGGCCGCGGTGGCTAG	10	9	27	25	17	er	independent
seq2565_all_clean_seqs_gap0_no20_0.4	TGCTTAGCAGGAAGTTAGTCTGCCTGTGGTAGCTCC	10	9	27	25	17	er	independent
seq2566_all_clean_seqs_gap0_no20_0.4	CACCTCAGCTTCCTGTGTAGCTGGGACCACAGGCAT	11	9	27	25	16	er	independent
seq2567_all_clean_seqs_gap0_no20_0.4	ACTCACTTCCGTTTAGCTTATCAACCACCAAGAGAC	8	6	25	23	17	er	independent
seq2568_all_clean_seqs_gap0_no20_0.4	CCAACACGGATACAAAAAATATCTCTCTACCACACT	8	7	30	28	22	er	ambiguous
seq256_all_clean_seqs_gap0_no20_0.4	AGCGGCTGCACAGGAAGTTGGTTTTCACAAAGGCAA	13	12	19	17	6	er	independent
seq2570_all_clean_seqs_gap0_no20_0.4	GTGCCCCGGACCTACGGATACCACACACAGACAGGC	16	15	21	19	5	er	independent
seq2571_all_clean_seqs_gap0_no20_0.4	CTGCGCGGCCGGAAGTCGGCGGTTTCCCAGACGACG	11	10	20	18	9	er	independent
seq2572_all_clean_seqs_gap0_no20_0.4	GGCCCTTCTGGGGCAGGATGTGGTGCCTGCCAAAGG	16	15	21	19	5	er	independent
seq2573_all_clean_seqs_gap0_no20_0.4	TCACTCTAACAGGATATTGTGGTTAACTATGTTGCC	12	11	20	18	8	er	cooperative
seq2574_all_clean_seqs_gap0_no20_0.4	AGCTCTGCCAGGAAGTGAGAACCACAGGCCTCCCCT	11	10	22	20	11	er	independent
seq2575_all_clean_seqs_gap0_no20_0.4	CCCCTTAGCACAGGATGTGGTCTTTGCATCTTCATT	13	12	18	16	5	er	cooperative
seq2577_all_clean_seqs_gap0_no20_0.4	GGAATTTCTTTTTCCGGTCCCGCAGGGTCAGCTGAG	13	11	20	18	7	er	independent
seq2578_all_clean_seqs_gap0_no20_0.4	TGACATGGCTTCCGCCTTGGGCTTTGTGGTCTCCCA	11	9	27	25	16	er	cooperative
seq2579_all_clean_seqs_gap0_no20_0.4	GGGCAGGCCGGATGTGGGAGACCACAAAGCCCAAGG	10	9	22	20	12	er	cooperative
seq2580_all_clean_seqs_gap0_no20_0.4	AGGCAGGGAAGTGGCGCAGAGGAGACCACAGGACAC	7	6	26	24	19	er	independent
seq2581_all_clean_seqs_gap0_no20_0.4	GGACTTCCTGAACTGGGAGGTCACCGACCACAACCT	6	4	28	26	22	er	independent
seq2583_all_clean_seqs_gap0_no20_0.4	CCAATGGGCAGGCGGAAACCGCGGGCTCGTGCTCCC	14	13	19	17	5	er	cooperative
seq2584_all_clean_seqs_gap0_no20_0.4	GACAGCAACTCCACTTCCTGTGGGCGAGGGCCCTGT	16	14	21	19	5	er	independent
seq2585_all_clean_seqs_gap0_no20_0.4	GAGGACGCGGAAGTCCTTCTTGCGGGGCGGAGCTAG	9	8	23	21	14	er	independent
seq2586_all_clean_seqs_gap0_no20_0.4	TTAACTCCACGGAAGAATAAACCACCACCGCTCACC	11	10	22	20	11	er	independent
seq2587_all_clean_seqs_gap0_no20_0.4	GGAACAGGAAAAGCCTCCGGCAGCCCCTGCGGGCGG	7	6	30	28	23	er	independent
seq2588_all_clean_seqs_gap0_no20_0.4	ACATGGTCTCGCTTCCTGTTTACACCACAGAAAGCT	14	12	25	23	11	er	cooperative
seq2589_all_clean_seqs_gap0_no20_0.4	CAGCTCTCTCGCTTCCTGTGGTGTAAACATGAAGCA	14	12	19	17	5	er	independent
seq258_all_clean_seqs_gap0_no20_0.4	TTTTATCCTTCCTTTTTTGTTCTTTGTGGTGGAGGT	10	8	27	25	17	er	independent
seq2590_all_clean_seqs_gap0_no20_0.4	CCCTGCTGTGTCTTCCTGTGGTAGCAGCAGTGGCAG	14	12	19	17	5	er	ambiguous
seq2591_all_clean_seqs_gap0_no20_0.4	GACAAAGAGGAAGTCCCCAAAAACCACAATAACAGT	9	8	24	22	15	er	cooperative
seq2594_all_clean_seqs_gap0_no20_0.4	CTCCGCCAGCCACCGGAACTGCGGCCCAGCAAAAAG	15	14	22	20	7	er	independent
seq2595_all_clean_seqs_gap0_no20_0.4	CCCCTACTTCCCTTTTTGCTGGGCCGCAGTTTCGGT	9	7	24	22	15	er	independent
seq2597_all_clean_seqs_gap0_no20_0.4	GGGTGCAGACGGGAAGTTGCGGCTGCCAGCGAAGCT	12	11	20	18	8	er	cooperative
seq2598_all_clean_seqs_gap0_no20_0.4	CCAGAAAGCTCCTCCTTCCGCCACAACACGATCACT	17	15	21	19	4	er	independent
seq2599_all_clean_seqs_gap0_no20_0.4	ACCAACCGGAAGTGATCGTGTTGTGGCCGAAGGAGG	8	7	24	22	16	er	independent
seq259_all_clean_seqs_gap0_no20_0.4	AGTTGGTTCCTTCCGGTGGGTTTGTGGGTTTGGGGT	12	10	25	23	13	er	cooperative
seq2600_all_clean_seqs_gap0_no20_0.4	GGGCAGGTGCGGATGCCGAGGAGAGTGGTCACCTCG	11	10	26	24	15	er	independent
seq2601_all_clean_seqs_gap0_no20_0.4	TGGTTTCCGGGCTGGGGTTAGAATAGGCCACAAGGT	6	4	28	26	22	er	independent
seq2602_all_clean_seqs_gap0_no20_0.4	TCTGGGCTGACTTCCTGGCTTCGTCCCACAACTTCA	13	11	26	24	13	er	independent
seq2603_all_clean_seqs_gap0_no20_0.4	AACAGAGACCCGGAAGTTGTGGGACGAAGCCAGGAC	12	11	20	18	8	er	independent
seq2604_all_clean_seqs_gap0_no20_0.4	CCCCTCGCCCTTCCGCATTGCGGGTTACTTCGGTTG	12	10	21	19	9	er	ambiguous
seq2606_all_clean_seqs_gap0_no20_0.4	AAATCACGTACCCGGAAACCACATGCACAGAAGTGG	14	13	19	17	5	er	cooperative
seq2607_all_clean_seqs_gap0_no20_0.4	CCCTGGGGCCCCACTTCCTTGCCCACAAGAAAGGAC	16	14	23	21	7	er	independent
seq2609_all_clean_seqs_gap0_no20_0.4	TTTCCACTTCCTGTTCTACTTGTGGCTACTGACTCA	9	7	23	21	14	er	independent
seq260_all_clean_seqs_gap0_no20_0.4	GCAGCCAGGGTAGGAAGTGGTAAGACCTCCCTGTGA	13	12	18	16	5	er	cooperative
seq2610_all_clean_seqs_gap0_no20_0.4	TTTCCAGAGGATGTAGCTTCTGCGGGAGAGCTTCAA	9	8	23	21	14	er	independent
seq2611_all_clean_seqs_gap0_no20_0.4	TATGGGGCCGGAAGCCATTCACCACAAACACTGTGT	10	9	22	20	12	er	cooperative
seq2612_all_clean_seqs_gap0_no20_0.4	GCAAACAGCACATCCGGTGTGGTCGACGGGTCCTCC	13	11	20	18	7	er	independent
seq2613_all_clean_seqs_gap0_no20_0.4	CAAAAGTGCTTCCTCTCGAGGGGTTGTGGTTCTTAC	11	9	27	25	16	er	independent
seq2614_all_clean_seqs_gap0_no20_0.4	GTCCCCGACTTCCGCTCTCGGTTGGTGGTTGGCTTT	11	9	26	24	15	er	independent
seq2615_all_clean_seqs_gap0_no20_0.4	GTAGCCGGGTGTTCCGGAGCGCTGCGGGCAAAGCAG	13	11	25	23	12	er	independent
seq2616_all_clean_seqs_gap0_no20_0.4	CCGAGCCGGCCTCTTCCGCCGCAAGTCCCTCCCCAA	15	13	19	17	4	er	independent
seq261_all_clean_seqs_gap0_no20_0.4	TGCACACATGAGGAAGGGGTAAGTGGTTTTCCCTAC	12	11	24	22	12	er	independent
seq2622_all_clean_seqs_gap0_no20_0.4	GTGGTCGGGAGGGGAAGTGAGGCGGTTACCTCGGCG	13	12	23	21	10	er	independent
seq2623_all_clean_seqs_gap0_no20_0.4	GCTGCCGGAAAAGGCGCCGAGGTAACCGCCTCACTT	7	6	26	24	19	er	independent
seq2624_all_clean_seqs_gap0_no20_0.4	GTGGCTATGGGAAGTGGGGTGCGGTTTCTGCCGGGG	10	9	22	20	12	er	cooperative
seq2625_all_clean_seqs_gap0_no20_0.4	CCAGAGGGCGGAAGTGGGAGCTGCGACCGCGCTCCC	10	9	27	25	17	er	cooperative
seq2626_all_clean_seqs_gap0_no20_0.4	TCTGTTCTTCCTTTTCCTGTGCGGTGTGCCCCAAAC	15	13	22	20	7	er	independent
seq2627_all_clean_seqs_gap0_no20_0.4	CCCCTATATCACAGGATGCCGCAAACTAGTAACAGG	14	13	19	17	5	er	cooperative
seq2628_all_clean_seqs_gap0_no20_0.4	GTTTGAAGGGAAGTGGGTGTTGACCTGCGGGCAACT	9	8	28	26	19	er	independent
seq2629_all_clean_seqs_gap0_no20_0.4	ACCCGGATGTCGTTGGGCAGGAACTGCGGTGAGGGC	5	4	27	25	22	er	cooperative
seq262_all_clean_seqs_gap0_no20_0.4	AGCTAGACTACAGGAGGAAACCACAGCCTAAACCAG	16	15	21	19	5	er	cooperative
seq2630_all_clean_seqs_gap0_no20_0.4	TCCCACATCCTGTGCTCGTGCAGTGGTTAGGCTCAA	8	6	24	22	16	er	independent
seq2632_all_clean_seqs_gap0_no20_0.4	CCATGAGGAGGGAGGAAATAGTGGTACGAGGGCTGC	14	13	22	20	8	er	independent
seq2633_all_clean_seqs_gap0_no20_0.4	GGGTCTCCAGGAAGCCACTCACCACAAACTTTGACA	10	9	22	20	12	er	cooperative
seq2635_all_clean_seqs_gap0_no20_0.4	CCCCTGCCCCTTCCTGGAAGGCTGCGGTGTAACACC	12	10	25	23	13	er	cooperative
seq2636_all_clean_seqs_gap0_no20_0.4	GCTGTGCCGGCAGGATGTGGTCTTTGGTTTCTGTTT	13	12	18	16	5	er	cooperative
seq2637_all_clean_seqs_gap0_no20_0.4	TACCGCTGCTTCCTGCCTGCGCGGTGAGCCTGTGCC	11	9	22	20	11	er	independent
seq2638_all_clean_seqs_gap0_no20_0.4	CAGTGGCAGGAAGAGGTCAGAAACCACTCGTGGTGG	9	8	24	22	15	er	independent
seq2639_all_clean_seqs_gap0_no20_0.4	GCCTGTCGCAGGAACGGAAGTGGTTACGGCCCTAGT	16	15	21	19	5	er	cooperative
seq263_all_clean_seqs_gap0_no20_0.4	GCTTTGCAGTTTCCTCTGTGGAACACCACACACAGT	12	10	26	24	14	er	independent
seq2641_all_clean_seqs_gap0_no20_0.4	AAGGTGGAAAAAGGATGTGGTTCTAAGCTGGCTTCT	13	12	18	16	5	er	independent
seq2643_all_clean_seqs_gap0_no20_0.4	TGAGGAGAGCGAGGAAGTGGTTTTCTCTTCGCACAG	13	12	18	16	5	er	cooperative
seq2644_all_clean_seqs_gap0_no20_0.4	CAACAACCGGAAGTGGGGCGGGCCGCAGTACCCGCC	9	8	23	21	14	er	independent
seq2645_all_clean_seqs_gap0_no20_0.4	GCCCGCCCCGGAAGTGCAAACTGTGTGGTCTGGCAG	10	9	26	24	16	er	cooperative
seq2646_all_clean_seqs_gap0_no20_0.4	GCCAGCGGGGCTTCCGGCCCCGCAGGCAGAAGTCGA	13	11	20	18	7	er	independent
seq2647_all_clean_seqs_gap0_no20_0.4	CCTTTCCGCGAGACCTTCCGCGGTTATCCAGCGAGT	17	15	21	19	4	er	independent
seq2648_all_clean_seqs_gap0_no20_0.4	AATGATTACCTAACAGGAAAACCACATTGGTCATTT	16	15	22	20	6	er	cooperative
seq2649_all_clean_seqs_gap0_no20_0.4	CTTCATCAACCCATCCTGTCTTGTGGTTAAGTCAAG	14	12	24	22	10	er	cooperative
seq264_all_clean_seqs_gap0_no20_0.4	GCTTTGCAGTTTCCTCTATGGAACACCACACACAGT	12	10	26	24	14	er	independent
seq2650_all_clean_seqs_gap0_no20_0.4	AAAGCATTTCCTGCCTTGACTTAACCACAAGACAGG	9	7	25	23	16	er	cooperative
seq2651_all_clean_seqs_gap0_no20_0.4	CTTGCCACACTTCCTCTTGTTTTGAACCACTATATT	12	10	27	25	15	er	independent
seq2652_all_clean_seqs_gap0_no20_0.4	AAAAAGCCGGATGTGAAGGCTGTGGTTCTCAACCCG	9	8	23	21	14	er	cooperative
seq2654_all_clean_seqs_gap0_no20_0.4	GTCTTGTACCCTAGAGGATGTGGTAGCCCTAAATAA	16	15	21	19	5	er	cooperative
seq2655_all_clean_seqs_gap0_no20_0.4	TTCTGCTACATCCTGCCCACTCCCTGTGGCTTCCAC	11	9	27	25	16	er	independent
seq2656_all_clean_seqs_gap0_no20_0.4	ACCTTGCCTAGAGGAAGTGGTTTTTCGAATCTGAGT	13	12	18	16	5	er	cooperative
seq2657_all_clean_seqs_gap0_no20_0.4	GAGAAACAAACAGGATGTGGTCTCTGCCCTGGAGGA	13	12	18	16	5	er	independent
seq2658_all_clean_seqs_gap0_no20_0.4	GTTGCAGGAAACGATGGGTTTTGTGGTATGAACTGC	7	6	24	22	17	er	cooperative
seq2659_all_clean_seqs_gap0_no20_0.4	AGCCTGGCCTCGGCAGGATGTGGGTGTAGGTCATGC	16	15	21	19	5	er	cooperative
seq265_all_clean_seqs_gap0_no20_0.4	TCCAGGCATTTCCCCCATGTTGGCTCACCGCACTAT	11	9	28	26	17	er	independent
seq2660_all_clean_seqs_gap0_no20_0.4	GCCTGTGGAGTTGCAGGATGTGGTTGGCGAAAAGAA	16	15	21	19	5	er	cooperative
seq2661_all_clean_seqs_gap0_no20_0.4	ACGAGGTTGGCCTCATCCGGTGGTTTTCGCAGCACG	16	14	21	19	5	er	independent
seq2662_all_clean_seqs_gap0_no20_0.4	AGCACAGGTTCCCAGGAAATGTGGGTTGAACAAGGC	15	14	22	20	7	er	independent
seq2663_all_clean_seqs_gap0_no20_0.4	ACCTGAGCAGGAAGTAGCTGAGGTCGCGGTGCAGCA	10	9	27	25	17	er	independent
seq2664_all_clean_seqs_gap0_no20_0.4	TATCACGTTTCCTGCTGCTGCACCGCGACCTCAGCT	10	8	23	21	13	er	independent
seq2665_all_clean_seqs_gap0_no20_0.4	CTGTGCGAGGCAGGATGTGGTCTCCCGCCACCAGGG	13	12	18	16	5	er	cooperative
seq2666_all_clean_seqs_gap0_no20_0.4	CCAGCTACACAGGATGCTGCGGTGGGCGGAATGCTC	12	11	20	18	8	er	cooperative
seq2668_all_clean_seqs_gap0_no20_0.4	CCGGGAAGGCGGAAGCAGCAGAGACGCCGCAAGGCC	11	10	27	25	16	er	independent
seq2669_all_clean_seqs_gap0_no20_0.4	AGACCCGGATATGCGCCGGGGACCCCCAGACCGCGC	7	6	31	29	24	er	independent
seq266_all_clean_seqs_gap0_no20_0.4	GAAATCCATCACGGATGTGGGCTTTTTGCTCTCATT	13	12	18	16	5	er	ambiguous
seq2670_all_clean_seqs_gap0_no20_0.4	TTTCTGACACTCTCAGGATGTGGGTTTTCACACTGT	16	15	21	19	5	er	cooperative
seq2671_all_clean_seqs_gap0_no20_0.4	TTTCTGACACTCTCAGGATGTGGGTTTTCGCACTGT	16	15	21	19	5	er	cooperative
seq2672_all_clean_seqs_gap0_no20_0.4	TTTCTGAAACCCTCAGGATGTGGGTTTTCACACTGT	16	15	21	19	5	er	cooperative
seq2673_all_clean_seqs_gap0_no20_0.4	GTCTTTCACTCCACTTCCGCCCCCACAAAACATACA	16	14	23	21	7	er	independent
seq2675_all_clean_seqs_gap0_no20_0.4	AAGCAGAGCTCAGGATGTGGTGCCGTGCGAGGGCGG	13	12	18	16	5	er	independent
seq2676_all_clean_seqs_gap0_no20_0.4	CAGCTTTCCGGCCTGCAGCACAGGCAATGTGGTTTT	7	5	30	28	23	er	cooperative
seq2678_all_clean_seqs_gap0_no20_0.4	GCAGAGTTTACAACAGGATGTGGTTATTGGCGCTGC	16	15	21	19	5	er	cooperative
seq2679_all_clean_seqs_gap0_no20_0.4	CTCACAGAGCAAGTAGGATGTGGTTTCCAGGGGCTG	16	15	21	19	5	er	cooperative
seq267_all_clean_seqs_gap0_no20_0.4	CAGAGGAAGCCCACCCCATAAAAGAACCACAGATAA	5	4	27	25	22	er	independent
seq2681_all_clean_seqs_gap0_no20_0.4	GACAAAACACAGAAAGGAAGTGGTCAACTATTGCAC	16	15	21	19	5	er	cooperative
seq2682_all_clean_seqs_gap0_no20_0.4	CCTCACCCAGGAAGTGGCTGCGGCTGTCTCAGGGTT	10	9	21	19	11	er	independent
seq2683_all_clean_seqs_gap0_no20_0.4	TTGGCTTTGTGTTTCCGCGGTGTTGGTAGAGTCTCG	14	12	18	16	4	er	independent
seq2684_all_clean_seqs_gap0_no20_0.4	ACACAAACAGGAAGTGTTTGTGGTCCCTGCCTTTAG	10	9	21	19	11	er	cooperative
seq2685_all_clean_seqs_gap0_no20_0.4	GGAGAGTTGACTTCCGGCGGCTTGTGGGAGTGCTGG	13	11	25	23	12	er	independent
seq2686_all_clean_seqs_gap0_no20_0.4	AAAATTAAAGCAGGAAGTAATCAACCACATCAAATG	13	12	25	23	12	er	cooperative
seq2687_all_clean_seqs_gap0_no20_0.4	CCGTGGAAGGAAACGCTGCCAACCGCAACAGAAATG	9	8	23	21	14	er	cooperative
seq2688_all_clean_seqs_gap0_no20_0.4	GCTCTTCACTTCCTGTGGCTCCCGCAGCGGCCGCCG	11	9	22	20	11	er	independent
seq2689_all_clean_seqs_gap0_no20_0.4	AAGTGAAGAGCTTCCGCCGGGAGACCGCGGCTGCAG	13	11	25	23	12	er	independent
seq268_all_clean_seqs_gap0_no20_0.4	TTGTCGGGTATGGGATGTGGGCAGAGAGTATGATGG	13	12	18	16	5	er	independent
seq2690_all_clean_seqs_gap0_no20_0.4	GGAACGGAGGCGGAAGGGGCCCTGCGGCGACGACGT	12	11	25	23	13	er	cooperative
seq2691_all_clean_seqs_gap0_no20_0.4	CATCTACTGAGGAAGTGTAAGCCACAATAAGAAGCC	11	10	22	20	11	er	cooperative
seq2692_all_clean_seqs_gap0_no20_0.4	GCAACAGCGATCCCCGGAAACCACAAGGCGAGATGT	16	15	21	19	5	er	ambiguous
seq2694_all_clean_seqs_gap0_no20_0.4	CGAGTAGAGATAGCAGGAAGTGGTTTATTCTGAGGT	16	15	21	19	5	er	cooperative
seq2695_all_clean_seqs_gap0_no20_0.4	AGTTTCTTCTTTCCGGTGGGTTTGTGGTCTTGCTGA	12	10	25	23	13	er	cooperative
seq2696_all_clean_seqs_gap0_no20_0.4	ACACCGTTCAGGAAGACAAAGCCACACCTCACACCA	11	10	22	20	11	er	ambiguous
seq2697_all_clean_seqs_gap0_no20_0.4	ACACCGCTCAGGAAGACAAAGCCACACCTCACACCA	11	10	22	20	11	er	ambiguous
seq2698_all_clean_seqs_gap0_no20_0.4	ACACCACTCAGGAAGACAAAGCCACACCTCACACCG	11	10	22	20	11	er	independent
seq2699_all_clean_seqs_gap0_no20_0.4	CCAGCAAAGGAAGCTTGGTCAACCACAGCAGCCTGT	9	8	23	21	14	er	cooperative
seq269_all_clean_seqs_gap0_no20_0.4	CTTATCTTCTTCCTGTGAGCTGTGTGTGGGTGGCTC	11	9	27	25	16	er	independent
seq2700_all_clean_seqs_gap0_no20_0.4	CATGGGGAGGAGGAAGTGGTGGCGGCCGCAGGCCAG	12	11	26	24	14	er	cooperative
seq2701_all_clean_seqs_gap0_no20_0.4	CACTTGTCCTTCCTGGCCTGCGGCCGCCACCACTTC	11	9	21	19	10	er	independent
seq2702_all_clean_seqs_gap0_no20_0.4	GTTGTCTTCTTCCTGAGTAAACCGCAGTGCAGAGAA	11	9	22	20	11	er	cooperative
seq2704_all_clean_seqs_gap0_no20_0.4	GCCCAATTCCCGAATCCGGTCTGCGGCGCGCTCGGG	15	13	24	22	9	er	independent
seq2705_all_clean_seqs_gap0_no20_0.4	CTACGACTTCCGTGATGCCTTGCGGTTGCTGTAGCC	9	7	23	21	14	er	cooperative
seq2706_all_clean_seqs_gap0_no20_0.4	GAAGAAGTCAGGAAATGCTGCCGCAGCAGCCAGCCC	11	10	21	19	10	er	independent
seq2707_all_clean_seqs_gap0_no20_0.4	CTAAACCGGAAGCCGCCCCTCTGACCGCTCTAAAAC	8	7	25	23	17	er	independent
seq2708_all_clean_seqs_gap0_no20_0.4	ACAGACCAGGGGATTTCCTGTGGGTGGAGTCCTCAG	16	14	21	19	5	er	independent
seq2709_all_clean_seqs_gap0_no20_0.4	CTTGGCGGAAGTGGTGTGGGGGAGGTAGCCCGCAGT	7	6	30	28	23	er	cooperative
seq270_all_clean_seqs_gap0_no20_0.4	CAAGAATGAGAAAGGAAGCTGGCGGTTGGGCAGGTG	14	13	23	21	9	er	independent
seq2710_all_clean_seqs_gap0_no20_0.4	TCAATGACAGGAAGTTTTTAAACCACATACGGCTAA	10	9	23	21	13	er	cooperative
seq2711_all_clean_seqs_gap0_no20_0.4	TTTAAGGGCGGAAAGGCTTTAGCCGCAAAATGGCTT	10	9	23	21	13	er	cooperative
seq2712_all_clean_seqs_gap0_no20_0.4	TGCAGCTATGGCCGGAAGCCTGTGGGTGTGGGAGGA	14	13	23	21	9	er	independent
seq2713_all_clean_seqs_gap0_no20_0.4	CTTGCTCCCCACTTCCTACCACATTCAATGCCCGGA	14	12	19	17	5	er	independent
seq2714_all_clean_seqs_gap0_no20_0.4	TATGTGTTTTAGGCAGGATGTGGGTTTTAGTCTTTC	16	15	21	19	5	er	cooperative
seq2715_all_clean_seqs_gap0_no20_0.4	GGCAGCAAGAAAGGAAATAGTGTGGTTGGGTGGAGA	13	12	23	21	10	er	cooperative
seq2716_all_clean_seqs_gap0_no20_0.4	AGCTGCGGAGCATCCGCTGCGGTCCTCGCCGAGACC	13	11	20	18	7	er	independent
seq2717_all_clean_seqs_gap0_no20_0.4	TGCGACGGAAGCAGGAACTTGCTAACCACAAAACCC	7	6	26	24	19	er	cooperative
seq2718_all_clean_seqs_gap0_no20_0.4	AGGTCTCCGGAAGTGGGTCTGCGGCGCGCGGGATGC	9	8	22	20	13	er	independent
seq2719_all_clean_seqs_gap0_no20_0.4	GTCTGCTTAAAAACAGGAAACCACATATCTCCACCC	16	15	21	19	5	er	cooperative
seq271_all_clean_seqs_gap0_no20_0.4	CCTGACTCTGGGTTTCCTCCCAGCCACAGACACCTG	15	13	24	22	9	er	independent
seq2720_all_clean_seqs_gap0_no20_0.4	TCCCCCACTTCCTGGCAGCAGCAGTGTGGTGAGGAG	10	8	27	25	17	er	independent
seq2722_all_clean_seqs_gap0_no20_0.4	CAGGTGTTCAGGAAACAAAACCACAGACTTTTTCAC	11	10	21	19	10	er	cooperative
seq2723_all_clean_seqs_gap0_no20_0.4	ATCTTTTGATGAGGATGTGGTTTCCAGGCAGGTGCT	13	12	18	16	5	er	cooperative
seq2724_all_clean_seqs_gap0_no20_0.4	CCTTCCTTCCTGCTGTGTACGTTGTGGTCACAGCAC	8	6	25	23	17	er	cooperative
seq2726_all_clean_seqs_gap0_no20_0.4	AATGCAGCATTTCCTCTCCAGTTCACCACAGGCCCC	12	10	26	24	14	er	independent
seq2728_all_clean_seqs_gap0_no20_0.4	TAACCCGGAGCGGAAGGATCCCGCAGCGTGTGCGTA	12	11	21	19	9	er	independent
seq2729_all_clean_seqs_gap0_no20_0.4	CTCGCGATTCCTCTTCCGCTGCGGTCTCCTTAACAC	15	13	22	20	7	er	ambiguous
seq272_all_clean_seqs_gap0_no20_0.4	TGGGAACTTCCTGTGGAGGAGTGCATTGTGGGACTT	9	7	29	27	20	er	independent
seq2730_all_clean_seqs_gap0_no20_0.4	CACTTCCTCCTCGGGGGCCTCAGAAAACCACAGGGC	5	3	28	26	23	er	cooperative
seq2732_all_clean_seqs_gap0_no20_0.4	TCTGTGACTACGCGGATGTTGTGGGCGGCTACATGC	14	13	22	20	8	er	cooperative
seq2734_all_clean_seqs_gap0_no20_0.4	GAGTTCCGCCTCGCCGTTTGTCCCTTGCGGTACCCG	5	3	28	26	23	er	cooperative
seq2735_all_clean_seqs_gap0_no20_0.4	GCGCAAAGCCGGAAGGAGGGGTTTGCGGCTGGGGAG	11	10	26	24	15	er	cooperative
seq2736_all_clean_seqs_gap0_no20_0.4	CTTCGACCCCGGAAGCGCTAACCACCCCGGGGGCCG	11	10	22	20	11	er	cooperative
seq2738_all_clean_seqs_gap0_no20_0.4	TGGGGACAGGAAATGTTTACTGCCTGTGGCTTGCTG	9	8	27	25	18	er	independent
seq2739_all_clean_seqs_gap0_no20_0.4	TTGGAAACAGACAGGAAGCCACAGGCAGTAAACATT	14	13	19	17	5	er	independent
seq273_all_clean_seqs_gap0_no20_0.4	GCGTTAACAGTTTCCTTTGCGGCTGAGATCACAGTG	13	11	20	18	7	er	independent
seq2740_all_clean_seqs_gap0_no20_0.4	CACCTGCCTTGCTTCCTGCGGTGCAACCGGCGGGAG	14	12	19	17	5	er	independent
seq2741_all_clean_seqs_gap0_no20_0.4	CCCGCTCACGCCGGAAGTGGTTTGCGTTTTCAAGAT	13	12	18	16	5	er	cooperative
seq2742_all_clean_seqs_gap0_no20_0.4	GTGGTCTCTCCCGGAAAAACCACTTCCACCGAGAAC	13	12	20	18	7	er	cooperative
seq2743_all_clean_seqs_gap0_no20_0.4	CGGTGGCTTCCGGCCCATGGCGGTGGTTGGTGACTC	9	7	24	22	15	er	independent
seq2744_all_clean_seqs_gap0_no20_0.4	CGCCGGACGTAGTGACGTAGCGCGCAGCCGCAGCGG	5	4	28	26	23	er	independent
seq2745_all_clean_seqs_gap0_no20_0.4	CGAACGCCGGACGTTCTGGGCACGTGACCGCCACCC	9	8	28	26	19	er	cooperative
seq2746_all_clean_seqs_gap0_no20_0.4	CCCACCCAGGAAGCCGTCCTAACCACAACAGCCCTC	9	8	23	21	14	er	cooperative
seq2747_all_clean_seqs_gap0_no20_0.4	GGACCCAGCAGAGGATGTGGTTACAGGGCCATGATA	13	12	18	16	5	er	cooperative
seq2748_all_clean_seqs_gap0_no20_0.4	ACAATAACAGGAAGTGGTGGGGACTGCGGTGACCTG	10	9	27	25	17	er	cooperative
seq2749_all_clean_seqs_gap0_no20_0.4	GTCACAGGAAAGAAGGAGCCTCGCCTTAACCGCACC	7	6	30	28	23	er	cooperative
seq274_all_clean_seqs_gap0_no20_0.4	ATCAAACCCCAGGATATGTTGGTTTTGTAGGTTGTC	12	11	20	18	8	er	independent
seq2750_all_clean_seqs_gap0_no20_0.4	GCCCCAGGAAGAGCGCTCCCGCGAACTGCGGCGGTG	7	6	29	27	22	er	independent
seq2751_all_clean_seqs_gap0_no20_0.4	ATTAGAGGTAGAGGAAATACCACATGCAAAGGTTTG	13	12	20	18	7	er	independent
seq2752_all_clean_seqs_gap0_no20_0.4	GACACAAGCCTCACAGGATGTGGTCAAAGAAGGTTG	16	15	21	19	5	er	cooperative
seq2753_all_clean_seqs_gap0_no20_0.4	GGTAAAGCAACAGGATGTGGGTGTCTGACTTACAAT	13	12	18	16	5	er	independent
seq2754_all_clean_seqs_gap0_no20_0.4	AGAACAGGATGTTCTGAGTACAGCATGAACCTCAAA	7	6	30	28	23	er	independent
seq2755_all_clean_seqs_gap0_no20_0.4	GGATGACATCCGGCACCAACTTAACCACTAATCTCA	9	7	25	23	16	er	independent
seq2756_all_clean_seqs_gap0_no20_0.4	CAGCTAGCCGGAAGAAGCTGCGGCGACAGCGTCCTG	10	9	21	19	11	er	independent
seq2757_all_clean_seqs_gap0_no20_0.4	AACCCACCGGATGGAAGCTGCCACTCAGCCGCAGGA	9	8	29	27	20	er	cooperative
seq2759_all_clean_seqs_gap0_no20_0.4	CCCGGAGGACGTCCGGCCTCTGTGAGCCGCAACCTT	12	10	27	25	15	er	independent
seq2760_all_clean_seqs_gap0_no20_0.4	GTTTCATGTTAAGTAGGATGTGGTCAGTTAGCTTCG	16	15	21	19	5	er	cooperative
seq2761_all_clean_seqs_gap0_no20_0.4	GCGAAAGGAACTTCCTTTGCATGCGGTCAGAGTGCT	13	11	24	22	11	er	cooperative
seq2763_all_clean_seqs_gap0_no20_0.4	GGCCTCGGCCACATCCGGGTTCCACCGCAGATTCGG	14	12	25	23	11	er	cooperative
seq2765_all_clean_seqs_gap0_no20_0.4	GTGTGGAAGGAGGAAGCGAGAATGTGGTTACTTAGG	12	11	25	23	13	er	cooperative
seq2767_all_clean_seqs_gap0_no20_0.4	TGAGTCACATCCTGCAGGGCTGCGGTATCCTGGCTT	10	8	23	21	13	er	cooperative
seq2768_all_clean_seqs_gap0_no20_0.4	TGTCCGCACCCCACTTCCGCCCCGCAGAGGGCAACG	16	14	22	20	6	er	independent
seq2769_all_clean_seqs_gap0_no20_0.4	GGAGGCGGAAGTGGAGGTTGTTGTGGCTCCGAGGGC	7	6	24	22	17	er	independent
seq276_all_clean_seqs_gap0_no20_0.4	CCCAGCCACATCCCAGAGCAGCTAACCCACAGTCCT	11	9	27	25	16	er	independent
seq2770_all_clean_seqs_gap0_no20_0.4	TGGGGTTTCCGAGCCGCCCCCGAACCGCGCACCCGA	8	6	25	23	17	er	independent
seq2772_all_clean_seqs_gap0_no20_0.4	AATTGTCAATGGCAGGAAGCCACCACATGAAGAGAT	15	14	23	21	8	er	independent
seq2773_all_clean_seqs_gap0_no20_0.4	GGGTCACCCAGGGGAAGTTTGAACCACAGCCATCAG	13	12	24	22	11	er	independent
seq2774_all_clean_seqs_gap0_no20_0.4	CGATGCTTCCGGCCTCCTATTGGGTGGTTTCTTGGC	8	6	25	23	17	er	independent
seq2775_all_clean_seqs_gap0_no20_0.4	AGCCACATCCTGGACAAAAGCTGTGGTCTAGTAACC	8	6	24	22	16	er	independent
seq2776_all_clean_seqs_gap0_no20_0.4	GAAGCGGAAGTCGCTGAGGGGTGGTGAAGCGGTTGG	6	5	30	28	24	er	independent
seq2777_all_clean_seqs_gap0_no20_0.4	AGGTTCTCCAGAGGAGGAAGTGGTTTGCTGCAGGCT	16	15	21	19	5	er	cooperative
seq2778_all_clean_seqs_gap0_no20_0.4	CCCTTCGCTTCCGCTCCGCGTTCCCACAATGCAGTG	10	8	24	22	14	er	independent
seq277_all_clean_seqs_gap0_no20_0.4	TATTTCCTCCTGCAGGTCTGTTCTTTACCGCCTGAA	5	3	28	26	23	er	independent
seq2780_all_clean_seqs_gap0_no20_0.4	CCTCTGAGGCAGGAAGCTGCGGTGAAGTCTGAAGTT	12	11	20	18	8	er	cooperative
seq2781_all_clean_seqs_gap0_no20_0.4	TGACATCCTCTGAGGCAGCAAGCTGCGGTGAAGTCT	6	4	26	24	20	er	cooperative
seq2782_all_clean_seqs_gap0_no20_0.4	CTCCTGAGGAAGTAGTTACAGACACCACAGCGGAGG	8	7	25	23	17	er	independent
seq2785_all_clean_seqs_gap0_no20_0.4	AACTAAGTGCAGGGGAAGTTGTGGTTATTTTTTACC	14	13	22	20	8	er	cooperative
seq2786_all_clean_seqs_gap0_no20_0.4	TCTCTCTACGGAAGCTGGTAGGGCTGTGGGTGCTTC	10	9	27	25	17	er	independent
seq2787_all_clean_seqs_gap0_no20_0.4	CCAACGAGCACTTCCGCTTCCCGCAGCTCCAGCGGC	13	11	21	19	8	er	independent
seq2788_all_clean_seqs_gap0_no20_0.4	CAGGCAGGATGTTGACTCAGCTGCCAAGTGGTTTTG	7	6	29	27	22	er	ambiguous
seq2789_all_clean_seqs_gap0_no20_0.4	TGGATGGCAAGCAACGGAAACCGCAAACAGGGCTGT	16	15	21	19	5	er	cooperative
seq278_all_clean_seqs_gap0_no20_0.4	TTTATCATGAATGCAGGATGTGGGCAAACTCATGAC	16	15	21	19	5	er	cooperative
seq334_all_clean_seqs_gap0_no20_0.4	TTTATCATGAATGCAGGATGTGGGCAAACTCATGAC	16	15	21	19	5	er	cooperative
seq2790_all_clean_seqs_gap0_no20_0.4	TCTCTTCTCCCCATCCGCCCGAGACCACAGCCACTC	14	12	25	23	11	er	independent
seq2791_all_clean_seqs_gap0_no20_0.4	TCCCCTCTCCCCATCCGCCCGAGACCACAGCCACTC	14	12	25	23	11	er	independent
seq2792_all_clean_seqs_gap0_no20_0.4	TGCGCGCCGGCTTCCGCTGCGGCCAGTCGGGCGGCG	13	11	20	18	7	er	independent
seq2794_all_clean_seqs_gap0_no20_0.4	GGGGCCCCGGATGCACTGAGCGGCTGCGGCGCGGCT	9	8	27	25	18	er	independent
seq2795_all_clean_seqs_gap0_no20_0.4	GGGCCCGGGCCAGGAAGTGGTTTTGCAGAGGTGTTT	13	12	18	16	5	er	cooperative
seq2796_all_clean_seqs_gap0_no20_0.4	CCTGCGGATCACGGAAGTGGCTGCGGTCGGCGCCAT	13	12	24	22	11	er	cooperative
seq2797_all_clean_seqs_gap0_no20_0.4	ACCAAACGTCACATCCGCGGTGCTGCTGTAATCCCA	14	12	18	16	4	er	independent
seq2798_all_clean_seqs_gap0_no20_0.4	GCACCGTCCCAGCATCCGGACACCACAGCGGCCCTT	15	13	23	21	8	er	independent
seq2799_all_clean_seqs_gap0_no20_0.4	TTGCTCCCGGAAGCCCCGCCCGACCGCGGCTCCTGA	9	8	24	22	15	er	cooperative
seq27_all_clean_seqs_gap0_no20_0.4	GAGGGCCTGGGAGGAAGTGGGTTTTGCATACAGTCC	13	12	18	16	5	er	cooperative
seq2800_all_clean_seqs_gap0_no20_0.4	GCGAAAAACGCGGAAATGCGGTGGCGGCGGCCCGCT	12	11	19	17	7	er	cooperative
seq2801_all_clean_seqs_gap0_no20_0.4	CTTGCTTAACGCTTCCTGAGGGGTGGTTTGGGTTTT	14	12	24	22	10	er	independent
seq2802_all_clean_seqs_gap0_no20_0.4	GTCCCCCTTCCGGCTGCAGGTTGAGGTTTGGAACCT	9	7	24	22	15	er	independent
seq2803_all_clean_seqs_gap0_no20_0.4	CACTCCCCCATTCCGGCTGCAGGTTGAGGTTTGGAA	12	10	27	25	15	er	independent
seq2804_all_clean_seqs_gap0_no20_0.4	TCCAGGATGTGGGATGCCGTGCTGTACCGCATGTCA	5	4	27	25	22	er	cooperative
seq2805_all_clean_seqs_gap0_no20_0.4	CCGGTCCTGACCGGAAGCGGTAACCGTCACTCCTTC	13	12	18	16	5	er	ambiguous
seq2806_all_clean_seqs_gap0_no20_0.4	GGCACTTCCGGTCCTGACCTGAAGCGGTAACCGTCA	7	5	25	23	18	er	independent
seq2808_all_clean_seqs_gap0_no20_0.4	ACAGATACAGCCTCAGGAAGTGGTTTTGTATCTCTG	16	15	21	19	5	er	cooperative
seq2809_all_clean_seqs_gap0_no20_0.4	CTACAAACGGCTTCCTCCTGCCTAACCACAACCTCA	13	11	26	24	13	er	ambiguous
seq280_all_clean_seqs_gap0_no20_0.4	GTCAGGAAACACATAGTTGTGTTTAACCTCAGGAAA	5	4	27	25	22	er	independent
seq2810_all_clean_seqs_gap0_no20_0.4	GAAGCTCCCCAAACAGGATGTGGTTAGGGAGAGGGG	16	15	21	19	5	er	cooperative
seq2812_all_clean_seqs_gap0_no20_0.4	TGCAGCCTATTTCCTCTAACCCGCAGATCCACTATG	12	10	21	19	9	er	independent
seq2813_all_clean_seqs_gap0_no20_0.4	AGCCTTAATTACCCGGAAGTGCGGTCCCAGGGACTT	15	14	22	20	7	er	independent
seq2814_all_clean_seqs_gap0_no20_0.4	GGCGGTGACCGGAAGAGCTGAGTCACCGCAGGCGAC	11	10	26	24	15	er	cooperative
seq2816_all_clean_seqs_gap0_no20_0.4	CCCACTGCGCCAGGATGTGGTCAGGTCGGTGACGTT	13	12	18	16	5	er	cooperative
seq2817_all_clean_seqs_gap0_no20_0.4	GAACTGAAGAAGGCAGGAAGCCACAGGCTCCTGGGT	16	15	21	19	5	er	ambiguous
seq2818_all_clean_seqs_gap0_no20_0.4	GTGTTGGGTGGCTTCCTGCGGCGTTTCCACTCTCGC	14	12	19	17	5	er	independent
seq2819_all_clean_seqs_gap0_no20_0.4	TGGGCAAGATATCCTGGAAGTGGTTAAAAAAAATTA	12	10	21	19	9	er	cooperative
seq281_all_clean_seqs_gap0_no20_0.4	TTCTCTGATTTTCCTTCCGCTCCCACAGCCTCTCCC	16	14	23	21	7	er	independent
seq2820_all_clean_seqs_gap0_no20_0.4	TACGTCACTTCCGGGCCGCCGTCCTGCGGGCAAGGG	10	8	27	25	17	er	cooperative
seq2821_all_clean_seqs_gap0_no20_0.4	GAACACGGAAACACTGAGCTTTTACTTTGACCACAC	7	6	31	29	24	er	independent
seq2822_all_clean_seqs_gap0_no20_0.4	AGAAGGCGCCGGAAGTGGTCCCGCAGAGGCGGGGTG	11	10	21	19	10	er	independent
seq2823_all_clean_seqs_gap0_no20_0.4	CAGAGGACAGGATGCCAACCCCAAAACCGCAGCGAC	10	9	27	25	17	er	cooperative
seq2825_all_clean_seqs_gap0_no20_0.4	AGCACAAACCCAGGATGTGGTAAATGAAATGAAAAA	13	12	18	16	5	er	cooperative
seq2826_all_clean_seqs_gap0_no20_0.4	ATGACTCATTTCCTCACTCTCTACTCCCACAGAACC	11	9	27	25	16	er	ambiguous
seq2827_all_clean_seqs_gap0_no20_0.4	CAGCTGCTGACAGGAAAACCACAGTGGAAGGGGAAG	13	12	19	17	6	er	cooperative
seq2828_all_clean_seqs_gap0_no20_0.4	AGTGGCAGTGCAGGAAGTGGTTTGTCTGGTACAATC	13	12	18	16	5	er	cooperative
seq2829_all_clean_seqs_gap0_no20_0.4	CACCCTCACGGAAACAGCTGTGTGTAACCACCTCCA	10	9	28	26	18	er	independent
seq2830_all_clean_seqs_gap0_no20_0.4	GGCTCGGCAAACATCCGGCTCCGCGGTGGAACGGGA	14	12	24	22	10	er	independent
seq2831_all_clean_seqs_gap0_no20_0.4	CCGGGTAGGATCCGGTTGCCTTTCTGCGGTGGAGGA	11	9	27	25	16	er	cooperative
seq2832_all_clean_seqs_gap0_no20_0.4	AATCCAACACTTCCTCCTCCACCGCAGAAAGGCAAC	12	10	22	20	10	er	ambiguous
seq2833_all_clean_seqs_gap0_no20_0.4	TGAGAAAACAGGAAGCGCCCAGTCACCACAGAAAGC	11	10	26	24	15	er	independent
seq2834_all_clean_seqs_gap0_no20_0.4	GCGCACACATGCTTCCTGTGGTGACTGGGCGCTTCA	14	12	19	17	5	er	independent
seq2835_all_clean_seqs_gap0_no20_0.4	AGCACTTCCGTTTGGGCAGGGCTGCGGGCCGGAGGG	7	5	25	23	18	er	independent
seq2836_all_clean_seqs_gap0_no20_0.4	GTTGAGTTCCGGGGGAGGTTGAGTTCCTGCGGTCAA	8	6	30	28	22	er	cooperative
seq2837_all_clean_seqs_gap0_no20_0.4	GCAGCCCAGCTTCCTGCAGACCAAAACCACAAGCAG	12	10	27	25	15	er	cooperative
seq2838_all_clean_seqs_gap0_no20_0.4	ACCCCGGAAGTGTGGGCGCGGCTGCGGTTTAACCCG	6	5	25	23	19	er	cooperative
seq2841_all_clean_seqs_gap0_no20_0.4	GGGATCTACTTCCTCTCTCGGCCGCGGCCGCAGCAC	11	9	28	26	17	er	independent
seq2842_all_clean_seqs_gap0_no20_0.4	CCCCTCAGCTTCCGGGTGCTGCGGCCGCGGCCGAGA	11	9	22	20	11	er	independent
seq2843_all_clean_seqs_gap0_no20_0.4	CTTTCGCTTCCTTTCCCCGCCTCTTAGTCCCGCAGA	9	7	30	28	21	er	ambiguous
seq2844_all_clean_seqs_gap0_no20_0.4	TTGATTGGAGCAGGATGTGGTCAGAACAGTATGCAG	13	12	18	16	5	er	cooperative
seq2845_all_clean_seqs_gap0_no20_0.4	TGGGGAGGCAGGAAACGGGCCTTGTGGTTGGGGGGT	11	10	25	23	14	er	cooperative
seq2846_all_clean_seqs_gap0_no20_0.4	CACGGAGCCACTTCCGGCGGCTGTGGGCGCAAAACC	13	11	24	22	11	er	independent
seq2847_all_clean_seqs_gap0_no20_0.4	AAGTTTTGGGTTTTCCGCCCACAGCCGCCGAAAGTG	14	12	19	17	5	er	ambiguous
seq2848_all_clean_seqs_gap0_no20_0.4	CCATCGGAAGTTTTGGGTTTTGCGCCCACAGCCGCC	6	5	26	24	20	er	independent
seq284_all_clean_seqs_gap0_no20_0.4	TTCGCCCTTCCCTTCCTATGAAAACCACTTTCCTTC	14	12	25	23	11	er	independent
seq2850_all_clean_seqs_gap0_no20_0.4	CGGGAGGGGCAGGAAGCGGACTGCGGTGGGGAAGGG	12	11	24	22	12	er	cooperative
seq2851_all_clean_seqs_gap0_no20_0.4	AACAGCACACAGGAAGTTACCGCTGAAGCAAAGGAG	12	11	20	18	8	er	cooperative
seq2852_all_clean_seqs_gap0_no20_0.4	AACCCTTCCTGAAAGTAGATGGGGTATAAACCACAA	7	5	31	29	24	er	ambiguous
seq2853_all_clean_seqs_gap0_no20_0.4	AGGCGAAGGATGACTTCCTGCGGCACTACACAGTGT	16	14	21	19	5	er	independent
seq2854_all_clean_seqs_gap0_no20_0.4	GAGCTAGCCACTTCCTCCCCCACAACTACACCCAGG	13	11	20	18	7	er	independent
seq2855_all_clean_seqs_gap0_no20_0.4	GTGGGGCGGGCTTCCGGCGCTCCCACCGCGAGCCGA	13	11	26	24	13	er	independent
seq2856_all_clean_seqs_gap0_no20_0.4	TGGCTGTGTCCCGGAAGTGGTCATAAGCTGGGTCCC	13	12	18	16	5	er	independent
seq2858_all_clean_seqs_gap0_no20_0.4	AAAGGCGGAAGGGGGGCAGGGAACCCACAAAACAGA	7	6	25	23	18	er	independent
seq285_all_clean_seqs_gap0_no20_0.4	GGTTTTGGTAGGAAGGAAAGTGGTTTTCATAGGAAG	11	10	21	19	10	er	independent
seq2860_all_clean_seqs_gap0_no20_0.4	CCCGGCCACTTCCGCCTATTGCGGGCGTCGGCTAGG	11	9	22	20	11	er	cooperative
seq2861_all_clean_seqs_gap0_no20_0.4	TGGGGGATGGCAGCAGGATGTGGTTATCTCAGAAAG	16	15	21	19	5	er	cooperative
seq2862_all_clean_seqs_gap0_no20_0.4	GGGCCCTTCCTGTGGCGCCTGCCGAGCTGTGGTTGG	8	6	30	28	22	er	independent
seq2863_all_clean_seqs_gap0_no20_0.4	CTCCAGGGACAACCCGGAAACCACATTGCCCAGCGT	16	15	21	19	5	er	independent
seq2864_all_clean_seqs_gap0_no20_0.4	AGCAGCTGCCAGAGGAAGTCTGCGGTCGGAACAGGC	14	13	23	21	9	er	cooperative
seq2865_all_clean_seqs_gap0_no20_0.4	CTCAGGAATGCGGAAGTGCTCTGTGGGCACCCACCA	12	11	24	22	12	er	independent
seq2866_all_clean_seqs_gap0_no20_0.4	TTAACCAGACATTTCCTGTGGTCTAAGGTGACCCCA	14	12	19	17	5	er	ambiguous
seq2867_all_clean_seqs_gap0_no20_0.4	ACACCCCAGGCAGGATGTGGTAGGGGTTGCCCCAGA	13	12	18	16	5	er	ambiguous
seq286_all_clean_seqs_gap0_no20_0.4	ACCATCCTGTAGTCTGTTAAGTGAGCAACCGCATTA	5	3	29	27	24	er	cooperative
seq2870_all_clean_seqs_gap0_no20_0.4	GCTAGACAGGAAACAGTGAGCTTCTGTGGGCAGGAG	9	8	27	25	18	er	cooperative
seq2871_all_clean_seqs_gap0_no20_0.4	TCTGATGTGCCTTCTTCCTGACCACAGCAACTACTA	16	14	22	20	6	er	independent
seq2872_all_clean_seqs_gap0_no20_0.4	ACCCCAAGCCCAGGATGTGGTTTGGCCACTATTGAG	13	12	18	16	5	er	cooperative
seq2873_all_clean_seqs_gap0_no20_0.4	CCTTGCTGCAGGATGCTCTAACCACAAGCCCAGGAG	11	10	22	20	11	er	cooperative
seq2874_all_clean_seqs_gap0_no20_0.4	CAACGGCGTAGCCGGAAGTCAGTGGTTTTCGCCCCA	14	13	23	21	9	er	cooperative
seq2875_all_clean_seqs_gap0_no20_0.4	TGTGCTGACTACAGGATGCTGTGGTTAGTCAGGTTG	14	13	22	20	8	er	cooperative
seq2876_all_clean_seqs_gap0_no20_0.4	AGAATTACCAGGAAGCCGAGCGCTGCGGGCTAGCGG	11	10	26	24	15	er	independent
seq2878_all_clean_seqs_gap0_no20_0.4	ACTTTCGCGACGCAGGAAGCGCCCACAAAGGGAGGA	15	14	23	21	8	er	independent
seq2879_all_clean_seqs_gap0_no20_0.4	GCCGGCGACATCCTCCCTTTGTGGGCGCTCCCTGCA	11	9	22	20	11	er	independent
seq2880_all_clean_seqs_gap0_no20_0.4	CACTGATTAAGAGGAAGTGTGTGTGGTTATTACCGT	13	12	24	22	11	er	cooperative
seq2881_all_clean_seqs_gap0_no20_0.4	GAAGAGAAAGGAAACGGCTCGCGGTTTCTGGGGTTC	10	9	22	20	12	er	cooperative
seq2882_all_clean_seqs_gap0_no20_0.4	GCTGGTATGGCAGGAAGTTTCTCACCACAGTATACT	13	12	25	23	12	er	cooperative
seq2883_all_clean_seqs_gap0_no20_0.4	GTTGCCCCACTTCCTGCCAGTGGTTTTTGGTTGGCC	12	10	21	19	9	er	independent
seq2884_all_clean_seqs_gap0_no20_0.4	GTTATTCTCCCCTTCCTGTGGTGTGTTTTGATGGTA	14	12	19	17	5	er	independent
seq2885_all_clean_seqs_gap0_no20_0.4	AGCCTACATCCTGCACTGCTTAACCACAGCCCGCCT	9	7	24	22	15	er	cooperative
seq2886_all_clean_seqs_gap0_no20_0.4	AGAACCACTTCCTCTCAGTAAACCACAGAGACTGTA	10	8	23	21	13	er	cooperative
seq2887_all_clean_seqs_gap0_no20_0.4	CGAGCAGGAAGTGGCAAGATTTGATAGGCGGTCAGG	7	6	29	27	22	er	independent
seq2888_all_clean_seqs_gap0_no20_0.4	CCTCGCCCCCTTCCGCACCCACCCCACCGCGCTCCG	12	10	27	25	15	er	independent
seq2889_all_clean_seqs_gap0_no20_0.4	AAGAAAAAGGGAGGATGTGGTTTAGCAAAAGCACTG	13	12	18	16	5	er	cooperative
seq288_all_clean_seqs_gap0_no20_0.4	CTTTCTGGTTTCCTTCCTTTTTGGTTTTGGTTTCAT	15	13	22	20	7	er	independent
seq2890_all_clean_seqs_gap0_no20_0.4	GAGTGACTGCTAACGGATGTGTGGTTTCTTTAGTTT	15	14	22	20	7	er	cooperative
seq2891_all_clean_seqs_gap0_no20_0.4	TAACTACTTCCTTTTACTATCTACCACAATTTAATT	9	7	24	22	15	er	ambiguous
seq2892_all_clean_seqs_gap0_no20_0.4	TCTACATCCTGCAGTTCTCCATTGTGGCCATTAGGT	7	5	25	23	18	er	independent
seq2893_all_clean_seqs_gap0_no20_0.4	ATCATCTAGGAGACAGGATGTGGTTAGGGTGTTAAA	16	15	21	19	5	er	cooperative
seq2894_all_clean_seqs_gap0_no20_0.4	TTAGCACATCCTGGGTACACAGACCACAGCCTCCTC	9	7	24	22	15	er	ambiguous
seq2895_all_clean_seqs_gap0_no20_0.4	AGGAAACCACAAGTTATTCCCTGCAAAGGTCTTGAT	-999	-999	7	5	1006	er	cooperative
seq2896_all_clean_seqs_gap0_no20_0.4	ACCATAAGGACCGGAAGCAGAGACCACACTGGTGCT	13	12	24	22	11	er	independent
seq2898_all_clean_seqs_gap0_no20_0.4	GAAATGAGAGAACGGAAACCACAAGTCAAGGGGCTT	14	13	19	17	5	er	cooperative
seq2899_all_clean_seqs_gap0_no20_0.4	CGTTCTCTCATTTCCTGTGTGCACCCACATGAACCA	13	11	25	23	12	er	independent
seq2900_all_clean_seqs_gap0_no20_0.4	GAGGCCCAGGATGTGGCTGGAGGCCTGTGGTGGGAC	9	8	28	26	19	er	cooperative
seq2901_all_clean_seqs_gap0_no20_0.4	ACTTTAATAGAGTCCGGATGCGGTTAGGCTGACAGA	16	15	21	19	5	er	cooperative
seq2902_all_clean_seqs_gap0_no20_0.4	TCTAACGCTGAAGGAGGATGTGGTTTCCTATTGGAC	16	15	21	19	5	er	cooperative
seq2903_all_clean_seqs_gap0_no20_0.4	TGCACGGTAAGCAGGAAGCTGCGGCCGAGCTGAGTC	14	13	22	20	8	er	ambiguous
seq2904_all_clean_seqs_gap0_no20_0.4	GTTTCCACTTCCTGCTGTGCAGCAGTACCACCAAGA	10	8	28	26	18	er	independent
seq2905_all_clean_seqs_gap0_no20_0.4	AAGTGGAGAGCGGAAGTGAGCTGTGGGTGACTGCAG	12	11	24	22	12	er	independent
seq2906_all_clean_seqs_gap0_no20_0.4	TCTGGGACAGGAAAGACTTGTGGTTACTGCTGTTGA	10	9	21	19	11	er	cooperative
seq2907_all_clean_seqs_gap0_no20_0.4	AGCCGTCATTCAGGATGTGGTGACAGACATGGAGAC	13	12	18	16	5	er	cooperative
seq2908_all_clean_seqs_gap0_no20_0.4	TCCTAGCCATTTCCTATCCACCCTGTGGCTAATTTG	12	10	26	24	14	er	independent
seq2909_all_clean_seqs_gap0_no20_0.4	CTAGGCCACCGGAAGTCTCCGCAGTGGTTTTGCAAA	11	10	25	23	14	er	independent
seq290_all_clean_seqs_gap0_no20_0.4	TTACGTTAAGGAGGAAACTCTGTGGTTAAACTGTAG	13	12	23	21	10	er	cooperative
seq2910_all_clean_seqs_gap0_no20_0.4	AAACTCCCCCACTTCCGCCCACAGCCCTCTGGGCTT	14	12	19	17	5	er	independent
seq2912_all_clean_seqs_gap0_no20_0.4	GCTTACGTCACGTCCGGCGCCTGCGGCCCACCCCTC	13	11	24	22	11	er	ambiguous
seq2913_all_clean_seqs_gap0_no20_0.4	GGGGACCGGAAAGGGAGGGGTGGGCCGCAGGCGCCG	8	7	25	23	17	er	independent
seq2914_all_clean_seqs_gap0_no20_0.4	AGATTAGATGCAGGATGTGGTATACAAAGGCACGTT	13	12	18	16	5	er	cooperative
seq2915_all_clean_seqs_gap0_no20_0.4	ATGGCGAAGCAGGATGCCCTCAACCCACATACGGCA	12	11	25	23	13	er	independent
seq2916_all_clean_seqs_gap0_no20_0.4	TCACATTTTGCCGGATGTGGGTTGAGGGCATGCTGC	13	12	18	16	5	er	cooperative
seq2917_all_clean_seqs_gap0_no20_0.4	CACCTCACAGCCCGGATACAAACCGCCTACCCGCCC	14	13	23	21	9	er	independent
seq2918_all_clean_seqs_gap0_no20_0.4	AACAGTACTTCCGGGGCAAGTGAGCGCCCACAAGGC	10	8	28	26	18	er	independent
seq291_all_clean_seqs_gap0_no20_0.4	CCAACTTTTGAGGGATGTGGTTACGTTTTCTAGATC	13	12	18	16	5	er	cooperative
seq2920_all_clean_seqs_gap0_no20_0.4	CCACTCCAGGAAACTCCTCCAGGTGAGCCCACAACT	9	8	29	27	20	er	independent
seq2921_all_clean_seqs_gap0_no20_0.4	TGATGCAGGAAGGGGTGGAGTCACCACAGGAGGTAG	8	7	24	22	16	er	independent
seq2922_all_clean_seqs_gap0_no20_0.4	ATGTCCCCAGGAGGATGTGGTGTGTCCACAGGAGGA	13	12	18	16	5	er	cooperative
seq2923_all_clean_seqs_gap0_no20_0.4	GAATGGCGGATGTGGCTGGGGAGAGAAAGCCGCAGA	8	7	30	28	22	er	cooperative
seq2924_all_clean_seqs_gap0_no20_0.4	TGGGGCTAGGCTTCCGGGGCTCTGCGGTCCTCGGCC	13	11	25	23	12	er	cooperative
seq2925_all_clean_seqs_gap0_no20_0.4	TAAATACCTCACAGGAAATTTGAGGTTGGATGAGAT	14	13	23	21	9	er	independent
seq2926_all_clean_seqs_gap0_no20_0.4	GGAGGGGCTGGCCGGAAGTGAACCGCAGAGCACGCT	14	13	23	21	9	er	cooperative
seq2927_all_clean_seqs_gap0_no20_0.4	GCCACATATTTCCTGTGACAACCCTGTGGTGTGGCT	11	9	27	25	16	er	independent
seq2928_all_clean_seqs_gap0_no20_0.4	TTGAATATGAAAGGAAGTGGTTAGGTGATGTGTTCT	13	12	18	16	5	er	cooperative
seq2929_all_clean_seqs_gap0_no20_0.4	GCGAGAGGGAGGAAGTGACTCACCAACCACAACAAA	11	10	27	25	16	er	cooperative
seq292_all_clean_seqs_gap0_no20_0.4	TTGGTGACCTCTTCCTGTCCGCTGTGGTGTTGTTAC	13	11	25	23	12	er	independent
seq2930_all_clean_seqs_gap0_no20_0.4	CTTCTACTTCCTGCCCCGCCCCCAGCTGTGGTCACA	9	7	29	27	20	er	independent
seq2931_all_clean_seqs_gap0_no20_0.4	ATTTCGCTGAAAACAGGAAACCACGAAGCCCAGATG	16	15	21	19	5	er	cooperative
seq2932_all_clean_seqs_gap0_no20_0.4	GAGGAGGCTGAGGAGGAAGTGCGGTGGCTGTTCTGC	15	14	22	20	7	er	independent
seq2933_all_clean_seqs_gap0_no20_0.4	CTCTTCTTCAGGGTTTCCTGTGGGTACACTGAGAAC	16	14	21	19	5	er	independent
seq2934_all_clean_seqs_gap0_no20_0.4	AGCAGATTTGCTGCAGGAAACCACCGAGTCTCACGG	16	15	21	19	5	er	independent
seq2935_all_clean_seqs_gap0_no20_0.4	CAGGGCACCTCCTACTTCCCCCCGCAGATAACTACC	17	15	22	20	5	er	independent
seq2936_all_clean_seqs_gap0_no20_0.4	CCTGGGCAAGGCCGGATGCCTGTGGCTTCCAGGCTG	14	13	23	21	9	er	independent
seq2937_all_clean_seqs_gap0_no20_0.4	GGACTTCCTGAAGCCAGATCGGTTTACCACAGTCAG	6	4	27	25	21	er	independent
seq2938_all_clean_seqs_gap0_no20_0.4	CCGCTGAGAACAGGATGTGGGTGTCAGGAGGTGAAG	13	12	18	16	5	er	independent
seq2939_all_clean_seqs_gap0_no20_0.4	AGCGCTTCCTGGCTCCGGCCCCGCCCCTGCGGTCGG	7	5	30	28	23	er	cooperative
seq293_all_clean_seqs_gap0_no20_0.4	GAGCCTGTTGCTTCCGGTTCAGAGCCCACATGCTGG	13	11	26	24	13	er	independent
seq2940_all_clean_seqs_gap0_no20_0.4	TGGTTTCTCACTGGCGGATGTGGGTGGGTCGCCTCC	16	15	21	19	5	er	independent
seq2941_all_clean_seqs_gap0_no20_0.4	TTGCTTTATCACTTCCTGTTTGAGGTTTATATCCAT	14	12	23	21	9	er	independent
seq2942_all_clean_seqs_gap0_no20_0.4	CAAAGGTTAAATGCAGGATGTGGTTTCTGCAGACTC	16	15	21	19	5	er	cooperative
seq2943_all_clean_seqs_gap0_no20_0.4	GTGACCCAATACTTCCTGCCACAATACTGAGAACTC	14	12	19	17	5	er	independent
seq2945_all_clean_seqs_gap0_no20_0.4	GCGCAAGCAGGAAGCGTTTGCGGTGATCCCGGCGAC	10	9	21	19	11	er	cooperative
seq2946_all_clean_seqs_gap0_no20_0.4	GTTTCAGTATTTCCTGGTGCGGCGTACCACACCTAC	12	10	27	25	15	er	independent
seq2947_all_clean_seqs_gap0_no20_0.4	CCGCTTCCGGGACGCGAATCGCTCTGCGGCTGCGTC	6	4	27	25	21	er	independent
seq2948_all_clean_seqs_gap0_no20_0.4	TCTCTATGGTTTCCGTTGGGTGTGTGGTTTTTTTGT	12	10	25	23	13	er	cooperative
seq294_all_clean_seqs_gap0_no20_0.4	CATGGTGGTGACGCAGGATGTGGTGGTGGTGTAGAA	16	15	21	19	5	er	cooperative
seq2950_all_clean_seqs_gap0_no20_0.4	TCCCCTTTCCGGGAAGGGTTGGGGATCTGACCACGT	8	6	31	29	23	er	independent
seq2951_all_clean_seqs_gap0_no20_0.4	GCTTCTTCCGGCCGGGCCGAGAGGTGGTTACATTCG	7	5	25	23	18	er	independent
seq2952_all_clean_seqs_gap0_no20_0.4	ACCCTACTTCCGTTGCTGTGTTGCGGAGGTGACCTA	9	7	24	22	15	er	independent
seq2954_all_clean_seqs_gap0_no20_0.4	AATTGCGCATCTTTTCCGCCTACCGCACGGCCCCGC	15	13	23	21	8	er	independent
seq2955_all_clean_seqs_gap0_no20_0.4	AGGTCGCCCTCCGGATGCGGTCCCCACACCGCCTGC	13	12	18	16	5	er	cooperative
seq2956_all_clean_seqs_gap0_no20_0.4	GCCCCGGAAGCTCCTTAAGGAGGACCGTGTGGGTTT	6	5	30	28	24	er	cooperative
seq2957_all_clean_seqs_gap0_no20_0.4	AGATGGTGTGGCCGGATGGGGACCACATTGAAGAGA	14	13	23	21	9	er	independent
seq2958_all_clean_seqs_gap0_no20_0.4	GCTCTGGGTCACACAGGATGTGGTTTTTGAAGTTTG	16	15	21	19	5	er	cooperative
seq2959_all_clean_seqs_gap0_no20_0.4	CCACCACTCTAAGCAGGATGCGGTGCGACCCAAGAG	16	15	21	19	5	er	independent
seq295_all_clean_seqs_gap0_no20_0.4	TGGGGTGGTGACATGGGATGTGGTTTTGGGGTTGCA	16	15	21	19	5	er	cooperative
seq2960_all_clean_seqs_gap0_no20_0.4	TGCGCCAGCCTTCCTGTCGTGGTCACCGGTGGCAGC	12	10	20	18	8	er	independent
seq2961_all_clean_seqs_gap0_no20_0.4	AGTGTCCGCCGCTTCCTGGTTGCGGGTCAGCGCCCA	14	12	23	21	9	er	ambiguous
seq2962_all_clean_seqs_gap0_no20_0.4	CTCCTGTTCCGGCTCAAAGGGAAACCGCTGCTTTTC	8	6	25	23	17	er	cooperative
seq2963_all_clean_seqs_gap0_no20_0.4	CAAGTAATCTGCTCAGGAAGTGGTTTGAATAGAGGA	16	15	21	19	5	er	cooperative
seq2964_all_clean_seqs_gap0_no20_0.4	TCCTGGCAGAGACCGGAAGTGCGGTCCGCGGAGCGT	15	14	22	20	7	er	independent
seq2965_all_clean_seqs_gap0_no20_0.4	GGAAAGCGGAAGAAAAAAGCAAGATGGGACCGCAAG	8	7	30	28	22	er	cooperative
seq2966_all_clean_seqs_gap0_no20_0.4	CTTTTTGATTTCCTCAAGCATCCCACAAATACACAG	11	9	23	21	12	er	independent
seq2967_all_clean_seqs_gap0_no20_0.4	AACAGACAGGATGTGGCCTCTGCCAAAACCACCATC	9	8	29	27	20	er	cooperative
seq2968_all_clean_seqs_gap0_no20_0.4	GTTGGGTGGGGAAGTGGATGGTGGTTTTGGCAGAGG	10	9	22	20	12	er	independent
seq2969_all_clean_seqs_gap0_no20_0.4	CCTGTTTCCTGCCATCTGCCCTTCCTTTGTGGTCAA	7	5	30	28	23	er	cooperative
seq296_all_clean_seqs_gap0_no20_0.4	GAGCCCGCGGATGTCAGGTGTGCCCACATCTAAACA	9	8	24	22	15	er	independent
seq2970_all_clean_seqs_gap0_no20_0.4	GACTGAGATTTCCTGCCAGCAACCACATGGCTTGTC	11	9	23	21	12	er	independent
seq2971_all_clean_seqs_gap0_no20_0.4	AGCCGCCACTTCCTGTCTCTGCGGGTGCATGCTCTT	11	9	22	20	11	er	independent
seq2972_all_clean_seqs_gap0_no20_0.4	TCGCCCACTTCCCCACCTCTCAAAAGACCACAGGCA	10	8	28	26	18	er	ambiguous
seq2973_all_clean_seqs_gap0_no20_0.4	GGTTGTAAGTTCACAGGATGTGGTGTGTCCCTGTGG	16	15	21	19	5	er	independent
seq2974_all_clean_seqs_gap0_no20_0.4	CTCCATCTGCCCGGAAAACCGCAGCCGCCCCAACCT	13	12	19	17	6	er	cooperative
seq2975_all_clean_seqs_gap0_no20_0.4	AGGACCGGAAGTGCCCGAGGGCGGCCGCAGAACGGT	7	6	25	23	18	er	cooperative
seq2976_all_clean_seqs_gap0_no20_0.4	GGTCCGGAAACGATTCTGGACCTGCGGGTATATCCA	6	5	25	23	19	er	independent
seq2977_all_clean_seqs_gap0_no20_0.4	TCTTGCCCGGGTCGGAAATGGTGGTCACGAGCGCTT	14	13	22	20	8	er	independent
seq2978_all_clean_seqs_gap0_no20_0.4	GCTGACCCGGAAGCGCTCGTGACCACCATCTCCGAC	9	8	23	21	14	er	independent
seq2979_all_clean_seqs_gap0_no20_0.4	TCTGCCGCCAGCCCATCCGCGACCGCATCCAGATCT	16	14	23	21	7	er	cooperative
seq297_all_clean_seqs_gap0_no20_0.4	ATCTTCAGGAAGCGGTATCAACCTGAAAACCACCAC	8	7	30	28	22	er	cooperative
seq2980_all_clean_seqs_gap0_no20_0.4	ACAAGGACTTCCGCCTCCCTGCGGTCCCTCCCCTAC	10	8	22	20	12	er	independent
seq2981_all_clean_seqs_gap0_no20_0.4	AAAACAAGGACTTCCGCCTCCCTGCGGTCCCTCCCC	13	11	25	23	12	er	independent
seq2982_all_clean_seqs_gap0_no20_0.4	GCGGGGCGCAGGAAGCGGGGCGAAACCACTGTTGGC	11	10	26	24	15	er	cooperative
seq2983_all_clean_seqs_gap0_no20_0.4	CCCACCCGGAAATGAGCCAACAGTGGTTTCGCCCCG	8	7	24	22	16	er	independent
seq2984_all_clean_seqs_gap0_no20_0.4	CCCTGAGCACTTCCCCGTAAGGCTGCGGTGCACGGG	12	10	26	24	14	er	independent
seq2985_all_clean_seqs_gap0_no20_0.4	GAGGAACCCAAAGTAGGATGTGGTTTTGCAATTGGA	16	15	21	19	5	er	cooperative
seq2986_all_clean_seqs_gap0_no20_0.4	GTTCTCCACATCCTGTTCCGTAGCTGTGGTGCACCG	11	9	27	25	16	er	ambiguous
seq2987_all_clean_seqs_gap0_no20_0.4	TGAGCAAGTTCCTTCCTGTCTGTGGTCCAGGGTTTA	14	12	23	21	9	er	ambiguous
seq2988_all_clean_seqs_gap0_no20_0.4	TCAATAAGACAGGATGTTCTCCAACCGCATTAAGCT	12	11	25	23	13	er	cooperative
seq298_all_clean_seqs_gap0_no20_0.4	TTTTTAAGGTCAGGATGTGGGCACATCTAAGGGGCA	13	12	18	16	5	er	ambiguous
seq2992_all_clean_seqs_gap0_no20_0.4	GAAATCACATCCTTTTGCAAAACCACAGGTGTTTTG	10	8	23	21	13	er	cooperative
seq2993_all_clean_seqs_gap0_no20_0.4	GGACCGGTGTCTGGCGGATGCGGTCGTGAAGATAGG	16	15	21	19	5	er	cooperative
seq2994_all_clean_seqs_gap0_no20_0.4	ACACCGGAAGCCCAACAGCATGCCGAGTAACCACCC	6	5	31	29	25	er	independent
seq2995_all_clean_seqs_gap0_no20_0.4	GAAGCCCAACAGGATGCCGAGTAACCACCCACTGAA	12	11	25	23	13	er	independent
seq2996_all_clean_seqs_gap0_no20_0.4	CAGACCAGCCCAGGAAACAAGGAACCACAAAGCCAC	13	12	25	23	12	er	cooperative
seq2997_all_clean_seqs_gap0_no20_0.4	TGAGGGCATAGGAAGTGATGGCCGCAAGGGGATGCC	11	10	22	20	11	er	cooperative
seq2998_all_clean_seqs_gap0_no20_0.4	TTGGTGGCTTCCTGCCCAGGAGACCACACCCAGCTT	10	8	24	22	14	er	ambiguous
seq2999_all_clean_seqs_gap0_no20_0.4	CAGTGACAGGAAGTGGTTCAGCGGTTGTTTAGGGCT	9	8	22	20	13	er	independent
seq29_all_clean_seqs_gap0_no20_0.4	CTTACAGATAAGGAAACTGAGGTTAAAATGTAGGGG	12	11	20	18	8	er	independent
seq3000_all_clean_seqs_gap0_no20_0.4	ATTACAGGAAGTATGTCCTCCTCTGCCTAACCACTG	7	6	31	29	24	er	independent
seq3001_all_clean_seqs_gap0_no20_0.4	GAAACCCCATGGGCAGGATGTGGGTGAGCTGTCTGG	16	15	21	19	5	er	cooperative
seq3002_all_clean_seqs_gap0_no20_0.4	CAGTCAAGAGGAAATTATAAACCACTGCCTCTTTGA	10	9	22	20	12	er	independent
seq3003_all_clean_seqs_gap0_no20_0.4	GCCCTGACCCACATCCTGCCGCAGCCTGCTTGTCCT	14	12	19	17	5	er	cooperative
seq3004_all_clean_seqs_gap0_no20_0.4	TTGGTTGTTGCCAGAGGATGTGGGTTGGCGGGGGAG	16	15	21	19	5	er	cooperative
seq3005_all_clean_seqs_gap0_no20_0.4	GTAAATAAAGAGGAAGTCCCTATGCGGGGGATGGGG	12	11	25	23	13	er	independent
seq3006_all_clean_seqs_gap0_no20_0.4	CACCTCGGGGGTTTCCGGTCCGTGGTTAGCTCCTTC	14	12	23	21	9	er	cooperative
seq3007_all_clean_seqs_gap0_no20_0.4	CCTCTGTTCTTCACAGGAAGCCACAGGCCTCCCCTG	16	15	21	19	5	er	independent
seq3008_all_clean_seqs_gap0_no20_0.4	TACTTAGAGGAAATGTGGCCTGTGGTCTTGTCTCAC	9	8	23	21	14	er	cooperative
seq3009_all_clean_seqs_gap0_no20_0.4	CTGTTTCCTGCCTTTGCTGTCTGTGACCGCATCAGT	6	4	27	25	21	er	cooperative
seq300_all_clean_seqs_gap0_no20_0.4	GTAGGGAAGACGGGATGTGGGTTTTCAGCCGTGGCC	13	12	18	16	5	er	cooperative
seq3012_all_clean_seqs_gap0_no20_0.4	AACCTCTAAGGAAGCGGTGTGTGCACCCACATGCTG	10	9	27	25	17	er	independent
seq3013_all_clean_seqs_gap0_no20_0.4	CATTTCAGTCCAGGATGTGGGTGCACACACCGCTTC	13	12	18	16	5	er	cooperative
seq3014_all_clean_seqs_gap0_no20_0.4	GGCGCTAGGCTTCCGGATCGCGGTGGGCGGAGTTCA	12	10	21	19	9	er	independent
seq3015_all_clean_seqs_gap0_no20_0.4	CATGGGACCCGGAAGTGTGTGGTAAAGCGCCGGGGC	11	10	20	18	9	er	ambiguous
seq3016_all_clean_seqs_gap0_no20_0.4	TCCCATGCCAGTTGCATCCGCGGTATTGGGCAGGAG	17	15	21	19	4	er	independent
seq3017_all_clean_seqs_gap0_no20_0.4	CCCTGCCATTTCCTGCCCAATACCGCGTATGCAACT	11	9	23	21	12	er	independent
seq3018_all_clean_seqs_gap0_no20_0.4	GACTCTTCCGGCCCAGAGCTTTCGGAGTGCGGTTGC	7	5	30	28	23	er	ambiguous
seq3019_all_clean_seqs_gap0_no20_0.4	AGGCGGCAGGAAATGACCCCATCCCGCAGCCTGGGC	9	8	24	22	15	er	cooperative
seq3020_all_clean_seqs_gap0_no20_0.4	GAGTTGCTTCCGGCCGTGTTGGTGGTCTGAATTGAG	9	7	23	21	14	er	independent
seq3021_all_clean_seqs_gap0_no20_0.4	GTTCAGCGGACGGCTTCCTGCGGCTTGCTGGGGCCG	16	14	21	19	5	er	independent
seq3022_all_clean_seqs_gap0_no20_0.4	TGGAAGCGGCTTCCGGGGTGAATGCGGTTGGATCGT	12	10	25	23	13	er	cooperative
seq3023_all_clean_seqs_gap0_no20_0.4	TGCGCCGGGAGGAAGGGCTCCAAAACCACAGGGCGG	11	10	26	24	15	er	cooperative
seq3024_all_clean_seqs_gap0_no20_0.4	GCCGCGCGGAAGCCTCCGCCCTGTGGTTTTGGAGCC	8	7	24	22	16	er	cooperative
seq3025_all_clean_seqs_gap0_no20_0.4	ATCAAAGAACGGATATTGCTGTGACACCGCGGGGAC	11	10	27	25	16	er	independent
seq3026_all_clean_seqs_gap0_no20_0.4	TGAGCCCCAGCAAGGGGAAGTGGTTAACCCAGGGTC	16	15	21	19	5	er	cooperative
seq3027_all_clean_seqs_gap0_no20_0.4	CCAAAAACCCCAGGAGGATGTGGTGAGGAGGGAAGG	16	15	21	19	5	er	cooperative
seq3028_all_clean_seqs_gap0_no20_0.4	CCCGCCGGAAGGACGCGTCTGCGTCTCTGCGGCGAG	7	6	30	28	23	er	independent
seq3029_all_clean_seqs_gap0_no20_0.4	GCCCCCGGAAGCTGTCGCCCCGTGCGGTGTGTGCTG	7	6	25	23	18	er	independent
seq302_all_clean_seqs_gap0_no20_0.4	AATATACGGTGAGGATGTGGGCAAAAAACAAAGAGG	13	12	18	16	5	er	ambiguous
seq3030_all_clean_seqs_gap0_no20_0.4	GCCATCCAGGAAGTACAGACTCCCTGACCGCACTGA	9	8	28	26	19	er	cooperative
seq3031_all_clean_seqs_gap0_no20_0.4	CTGGCCAGCTCCCACGGATGTGGTAGGCAGGCAGCA	16	15	21	19	5	er	ambiguous
seq3032_all_clean_seqs_gap0_no20_0.4	CTGACAGCTTCCGCACAAAGCGCGGTCTATTTCTCC	10	8	23	21	13	er	independent
seq3033_all_clean_seqs_gap0_no20_0.4	ACCGCCGGAAGTTTCTGCCGCGGCTTTGCGGGGACG	7	6	29	27	22	er	cooperative
seq3034_all_clean_seqs_gap0_no20_0.4	ACAGGCTGTCTGCTTCCGTCAGCGGTTATTCCCTTG	15	13	23	21	8	er	independent
seq3036_all_clean_seqs_gap0_no20_0.4	ACCTTCCTGGCCCTGGGAGCTGGTTTGAGGTTGCAG	5	3	28	26	23	er	independent
seq3037_all_clean_seqs_gap0_no20_0.4	CTCTGAAGGAAGTGATGTTAGACGGCTGTGGGTGGT	8	7	29	27	21	er	cooperative
seq3038_all_clean_seqs_gap0_no20_0.4	GAAGTGATGTTAGACGGATGTGGGTGGTGCCTCCGG	16	15	21	19	5	er	cooperative
seq3039_all_clean_seqs_gap0_no20_0.4	CAGTTTGCCCCGGATGTTGACCGCCTTGAAGTCGTA	12	11	21	19	9	er	independent
seq303_all_clean_seqs_gap0_no20_0.4	GGTTGCCCCCTTCCTCTCTGTGGCACACACAGACCT	12	10	21	19	9	er	ambiguous
seq3040_all_clean_seqs_gap0_no20_0.4	CAGCCTTGCCGGAAGGCAGAGTTTGTGGTCAGACCG	11	10	26	24	15	er	cooperative
seq3041_all_clean_seqs_gap0_no20_0.4	TTACAGGGGCCGGAAGTGGCCTGCGGGCGGAGAAGT	12	11	24	22	12	er	independent
seq3043_all_clean_seqs_gap0_no20_0.4	CACCAGGACGCAACAGGAAACCACAAAGGCCTGAGA	16	15	21	19	5	er	cooperative
seq3044_all_clean_seqs_gap0_no20_0.4	TAAATAGGAAGTCAGAGTTTACTGCCGAACCCACAG	7	6	31	29	24	er	independent
seq3045_all_clean_seqs_gap0_no20_0.4	AAGTCAGAGTTTACTTCCGAACCCACAGTGCCAAGC	16	14	23	21	7	er	independent
seq3046_all_clean_seqs_gap0_no20_0.4	ATGCGAGTCTGCTTCCTGCCACAAATCACAATTTGA	14	12	19	17	5	er	independent
seq3047_all_clean_seqs_gap0_no20_0.4	AAAAAATGGAGGAAGTTACCTCCAGTGGTTTTGTGA	11	10	26	24	15	er	independent
seq3048_all_clean_seqs_gap0_no20_0.4	AATATCCTGTATGTCATGCTTAAAAAGCCACAAAAC	5	3	28	26	23	er	cooperative
seq3049_all_clean_seqs_gap0_no20_0.4	CAGGCACACATCCGGGAGCGGCCTGCGCCGCAAGGC	11	9	28	26	17	er	independent
seq304_all_clean_seqs_gap0_no20_0.4	AGAAACGTCAATTTCCTGGCCACAGAATCCACTGCC	14	12	20	18	6	er	independent
seq3051_all_clean_seqs_gap0_no20_0.4	ATGAGCTATTTCCTGCCTTGTGGTCAGAGCCAGACT	11	9	21	19	10	er	cooperative
seq3053_all_clean_seqs_gap0_no20_0.4	CTCAGGGTACCAGGATGTGGTTTAGCTTAGGGGTGG	13	12	18	16	5	er	cooperative
seq3054_all_clean_seqs_gap0_no20_0.4	CCTCCCACCTTGGCAGGAAGCGGTTTATCAGATTAA	16	15	21	19	5	er	cooperative
seq3056_all_clean_seqs_gap0_no20_0.4	GAACCACTTCCCTGAAACCATTTACCACATAAATCT	9	7	25	23	16	er	cooperative
seq3057_all_clean_seqs_gap0_no20_0.4	CGAGGGAGCCGGAAAGATGGTGGTTACCAGATCTGC	11	10	21	19	10	er	cooperative
seq3059_all_clean_seqs_gap0_no20_0.4	AGGCTCATTTCCTGTTTTCATGTGGTTTAGAGAAAA	10	8	23	21	13	er	cooperative
seq3060_all_clean_seqs_gap0_no20_0.4	AGGTTAATACCCGGAACTACCACAACCGTCTTCCCT	13	12	20	18	7	er	independent
seq3061_all_clean_seqs_gap0_no20_0.4	CTCACTTCCCCGGCAGCTCCCTCGCCCCGACCGCAG	7	5	31	29	24	er	independent
seq3062_all_clean_seqs_gap0_no20_0.4	GAACCTGGGAGGCGGAAGTTGCGGTTAGCCGAGATC	14	13	22	20	8	er	cooperative
seq3063_all_clean_seqs_gap0_no20_0.4	TAGGCCGGAAAGCACCACCGTCCTCCCGCAGGCCGC	7	6	26	24	19	er	independent
seq3064_all_clean_seqs_gap0_no20_0.4	TTACGACACTTCCGGCGACGCCCCGCAGCCTTCACC	11	9	23	21	12	er	independent
seq3065_all_clean_seqs_gap0_no20_0.4	CTTCCATCCAGGAAGCTTGTGGTGCAACAGCAGTGT	11	10	20	18	9	er	independent
seq3066_all_clean_seqs_gap0_no20_0.4	CGGGACACAGGAAGCCGTTGTGGGGCCCCGGGGCCA	10	9	21	19	11	er	independent
seq3067_all_clean_seqs_gap0_no20_0.4	TGCTCAAATGCAGGATGTGGTCTGAGAGTTTCTCCT	13	12	18	16	5	er	cooperative
seq3068_all_clean_seqs_gap0_no20_0.4	AAGCCCTAGAGGAAATTAGTACGTAACCACCTTCTG	11	10	27	25	16	er	independent
seq306_all_clean_seqs_gap0_no20_0.4	CTGAGTGAGACAGGATGTGGGCAGACCTCTAACACA	13	12	18	16	5	er	cooperative
seq3072_all_clean_seqs_gap0_no20_0.4	CTCTGGCAGGAAGCTCTGAGGGCTAAACCACAAAAA	9	8	28	26	19	er	cooperative
seq3074_all_clean_seqs_gap0_no20_0.4	AACGGACCCGGAAGGGGCAGGTCTTGTGGGCGGGTC	10	9	27	25	17	er	independent
seq3075_all_clean_seqs_gap0_no20_0.4	CAAGAGAAAGGAAGTGGAAGCTCTTGTGGTCTGGAA	10	9	27	25	17	er	cooperative
seq3077_all_clean_seqs_gap0_no20_0.4	CTCAGAGCTGCGGAAACTACAACTCCCACAAGGCTG	12	11	26	24	14	er	independent
seq3078_all_clean_seqs_gap0_no20_0.4	GAGGCGTTTCCGCCTCCTTTTCGCGGTTGCCTTCTC	9	7	24	22	15	er	ambiguous
seq3080_all_clean_seqs_gap0_no20_0.4	GCTCTGCAGGATGTGGCTGTGACCGCAGTGAGGAGC	9	8	23	21	14	er	cooperative
seq3081_all_clean_seqs_gap0_no20_0.4	CCCGACTTCCGCCGCTGGTGGCCACCCGCAGGTAGT	8	6	26	24	18	er	cooperative
seq3082_all_clean_seqs_gap0_no20_0.4	CTTCAGCCGCCACTTCCCCGCCCCCGCAGCCCGACA	15	13	24	22	9	er	independent
seq3083_all_clean_seqs_gap0_no20_0.4	CTAGCTGTGGACAGGAAACGAGTGGTTTTTGTGATC	14	13	23	21	9	er	ambiguous
seq3085_all_clean_seqs_gap0_no20_0.4	TGGCTGTTCAGCCTTCCGCTTGTGGCTCCACCCCCG	15	13	23	21	8	er	independent
seq3086_all_clean_seqs_gap0_no20_0.4	TCTCGTCCGGTCCTTGCTCCCCCTCCCCGCAGCGCT	6	4	27	25	21	er	independent
seq3087_all_clean_seqs_gap0_no20_0.4	TGGTTCCACCGACCGGAAGGGCCACAAGGATCCCCG	15	14	22	20	7	er	independent
seq3089_all_clean_seqs_gap0_no20_0.4	GACGCTCTCTTCCTGTCTTTGTGGCTCCAGAAAGGC	11	9	22	20	11	er	independent
seq308_all_clean_seqs_gap0_no20_0.4	AGCGGATTCCGGACATAACAATCTACAGCGGTCTTA	8	6	29	27	21	er	independent
seq6_all_clean_seqs_gap0_no20_0.4	AGCGGATTCCGGACATAACAATCTACAGCGGTCTTA	8	6	29	27	21	er	independent
seq3091_all_clean_seqs_gap0_no20_0.4	GCCCCCGGCTGGGCAGGATGTGGTGGCAGCTGCAGG	16	15	21	19	5	er	independent
seq3092_all_clean_seqs_gap0_no20_0.4	CCAAGTGTAAAACGGAAGCTCAACCACGAATCTTAC	14	13	24	22	10	er	cooperative
seq3093_all_clean_seqs_gap0_no20_0.4	CCCGGGGGCAGGAAATGTCGCCTTACCCACAGCCTT	11	10	27	25	16	er	cooperative
seq3094_all_clean_seqs_gap0_no20_0.4	TGTGTAACTTCCTGGCTTTGGTGGTTTCCCCCTCCT	10	8	22	20	12	er	independent
seq3096_all_clean_seqs_gap0_no20_0.4	CTGTGACACGTGCGGAAGCTGTGGTAAGTGCATCCA	14	13	22	20	8	er	cooperative
seq3098_all_clean_seqs_gap0_no20_0.4	CAGCACGCAGGAAGCACATGTGGTGGGGCTCTTCCA	10	9	21	19	11	er	independent
seq3099_all_clean_seqs_gap0_no20_0.4	GCTAAGAGCAGGAAATGATCTGGGAACCACCATCAC	11	10	27	25	16	er	independent
seq3100_all_clean_seqs_gap0_no20_0.4	ACCCACTTCCTGTTAGAGCATCTTTGCAACCACAGG	8	6	30	28	22	er	independent
seq3101_all_clean_seqs_gap0_no20_0.4	CGACTTCCGTCCCTGGGTGGGATCGAACCACCAACC	6	4	28	26	22	er	independent
seq3102_all_clean_seqs_gap0_no20_0.4	GAGCCCAACCGGCATCCGTCGCGGTTGGACGTGGGC	15	13	22	20	7	er	independent
seq3103_all_clean_seqs_gap0_no20_0.4	AGCTGCAGTTGGGCAGGAAACCACAATGTCGAAGAC	16	15	21	19	5	er	cooperative
seq3104_all_clean_seqs_gap0_no20_0.4	AGTCAGCAGAGAGGAAGTGGTTAGTCCTGCCTTGAA	13	12	18	16	5	er	cooperative
seq3105_all_clean_seqs_gap0_no20_0.4	AAACCCTGAGTAATCGGAAGTGGTTAGGAGTGAGAG	16	15	21	19	5	er	cooperative
seq3106_all_clean_seqs_gap0_no20_0.4	CAGAGGCCCGGCCTCTTCCGCCACAACTCCGGCCCG	17	15	21	19	4	er	independent
seq3107_all_clean_seqs_gap0_no20_0.4	TCGCACCGGAACCCCTTGGCGGATTATGTGGGTTCC	8	7	29	27	21	er	cooperative
seq3108_all_clean_seqs_gap0_no20_0.4	AGCTGCATTTCCGGGCAGGCAATGAAACCACAGAGT	10	8	28	26	18	er	cooperative
seq3109_all_clean_seqs_gap0_no20_0.4	GCATTTACGGGCAGGAAATGAAACCACAGAGTACAA	14	13	24	22	10	er	cooperative
seq3110_all_clean_seqs_gap0_no20_0.4	GTGAGCCTGTAAAGGAAATTGAGGTTATGTGGCTCA	14	13	22	20	8	er	cooperative
seq3112_all_clean_seqs_gap0_no20_0.4	GGTTGTGGAGTAGGATGTGGTGTCTAGCTTTCAGCA	13	12	18	16	5	er	ambiguous
seq3113_all_clean_seqs_gap0_no20_0.4	GCCCCTAAACCGGATGCGGCAGCCACCGCGGACCCC	12	11	26	24	14	er	cooperative
seq3114_all_clean_seqs_gap0_no20_0.4	ATAGACTCAGGAAGTGATTGTGGTAAGATTCTATAT	10	9	21	19	11	er	cooperative
seq3115_all_clean_seqs_gap0_no20_0.4	GTATCACTTCCTGTTTTCCTCTGTGGCTTACTGCTG	9	7	24	22	15	er	independent
seq3116_all_clean_seqs_gap0_no20_0.4	AGCTTCCTGTTTGGCCTTGCTGATGTCACCGCATTA	5	3	29	27	24	er	independent
seq3117_all_clean_seqs_gap0_no20_0.4	TGTGTATGAGAACGGATATAGGTGGTTTTATAAGGA	14	13	23	21	9	er	cooperative
seq3118_all_clean_seqs_gap0_no20_0.4	GTCGGGAAGTAGGCGGGGTGACGTGTGGTTGACGAG	5	4	26	24	21	er	independent
seq3119_all_clean_seqs_gap0_no20_0.4	CGGCTGTTTTCCAGGATGTTGTGGTCATGGCGGTGT	14	13	22	20	8	er	cooperative
seq3121_all_clean_seqs_gap0_no20_0.4	TGGCTGTGAGCTGCAGGATGTGGTCAGGAGAGGAAG	16	15	21	19	5	er	cooperative
seq3122_all_clean_seqs_gap0_no20_0.4	AGGCCTCGCTTCCTCTCCTGACCACACCCTGCAGCT	11	9	22	20	11	er	cooperative
seq3123_all_clean_seqs_gap0_no20_0.4	GAGGGGGAGGTTTCCGGGGCCTGTGGTTACTACACT	13	11	24	22	11	er	cooperative
seq3124_all_clean_seqs_gap0_no20_0.4	TCATAAGGAAGTGGAGTGTAGTAACCACAGGCCCCG	7	6	25	23	18	er	cooperative
seq3125_all_clean_seqs_gap0_no20_0.4	CATCCAGGACGGAAACAGCATCCCCACCGCGGGAGC	11	10	27	25	16	er	independent
seq3126_all_clean_seqs_gap0_no20_0.4	GGTTCTCTAGGGAGAGGATGTGGGTTTGTCTCTGGG	16	15	21	19	5	er	cooperative
seq3127_all_clean_seqs_gap0_no20_0.4	TTTGCACACATCCTGGCCTCCGCCTGACCACCTCCT	11	9	28	26	17	er	independent
seq3128_all_clean_seqs_gap0_no20_0.4	AGGCTGTGTGAAGGATGTGGTCAGGCGGAGGCCAGG	13	12	18	16	5	er	cooperative
seq3129_all_clean_seqs_gap0_no20_0.4	CTTCTGAGAGGAGGATGTGGTCAGATACCTACAAAT	13	12	18	16	5	er	cooperative
seq312_all_clean_seqs_gap0_no20_0.4	GTCCCCCGGAACCGTCTCCTCCCCCGCACGCGCCGC	8	7	24	22	16	er	independent
seq3130_all_clean_seqs_gap0_no20_0.4	GCAGAAGAGGAAATGGTTTGCCTGTGCGGTGGGGGA	9	8	27	25	18	er	cooperative
seq3131_all_clean_seqs_gap0_no20_0.4	CTGTGGCCTAGAAGCTTCCTGCCGCAGCTCTGAGGA	17	15	22	20	5	er	independent
seq3132_all_clean_seqs_gap0_no20_0.4	CGTGTGGGAGGCCGGAAGTTGCGGCTTCATTACTCG	14	13	22	20	8	er	cooperative
seq3133_all_clean_seqs_gap0_no20_0.4	TTTTATCTTCCGCGAGCCCTCATCCCACAACTCTTC	9	7	25	23	16	er	independent
seq3134_all_clean_seqs_gap0_no20_0.4	TTCACTTCCACCACTTCCTGTGGGTTTTGTTCATCC	16	14	21	19	5	er	cooperative
seq3135_all_clean_seqs_gap0_no20_0.4	CAGAACGGTCCCCGGAACACTGCGGTTCCCGCCTGG	14	13	23	21	9	er	cooperative
seq3136_all_clean_seqs_gap0_no20_0.4	ACTTCACTTCCCAACCTCCCCTGTGGTTAGGTGTGG	9	7	24	22	15	er	cooperative
seq3137_all_clean_seqs_gap0_no20_0.4	CTGGTAGAAAAGGAAGCAGGTTGTGGTGAGCATTTA	12	11	24	22	12	er	cooperative
seq3138_all_clean_seqs_gap0_no20_0.4	CTGAAACAGGAAACAGACAAAGCCACAAGGTTCGCA	9	8	23	21	14	er	cooperative
seq3139_all_clean_seqs_gap0_no20_0.4	AACATCCGGTTCCCGGTTCTGCCCCCTACCGCAGCT	5	3	29	27	24	er	cooperative
seq313_all_clean_seqs_gap0_no20_0.4	GCGGCGAACCGGACGCCCCAACCACCCGCCCCCCAC	11	10	22	20	11	er	independent
seq3140_all_clean_seqs_gap0_no20_0.4	GACTGGACAACTTCCTGGTGGAAAACCGCGACTCTT	13	11	26	24	13	er	cooperative
seq3142_all_clean_seqs_gap0_no20_0.4	GCTTTTCCGCTCCCAGAGTGCCCCGCCCACAGTTCA	6	4	27	25	21	er	independent
seq3143_all_clean_seqs_gap0_no20_0.4	CAGAAAAGGCAGGAAGTGGTACAAACCACAAAAGGC	12	11	26	24	14	er	cooperative
seq3144_all_clean_seqs_gap0_no20_0.4	TTTGTGCCCCAACTTCCTCTGTGGCTTTTGGGTGGG	15	13	22	20	7	er	cooperative
seq3145_all_clean_seqs_gap0_no20_0.4	AGGTGGGAGGAAGTTCCTACCCCGGCGCGGTGTGCA	9	8	28	26	19	er	independent
seq3146_all_clean_seqs_gap0_no20_0.4	TGACGGCAGGCAGGATGTGGTGAGACAAATCCACTC	13	12	18	16	5	er	cooperative
seq3148_all_clean_seqs_gap0_no20_0.4	CAAGCCACTTCCTTTCTTGCTCCCACAACCTGTGTT	10	8	23	21	13	er	independent
seq3149_all_clean_seqs_gap0_no20_0.4	TGGAGAGCACAGGAAGTGGCCCACAGCCCAGGCCAA	12	11	21	19	9	er	independent
seq3150_all_clean_seqs_gap0_no20_0.4	ACCCAGGAGGCGGAAGTTGTGGTGAGCCGAGATCGC	12	11	20	18	8	er	cooperative
seq3152_all_clean_seqs_gap0_no20_0.4	TATCAATAAGGAAGTACAATCACCAAACCACAAGCC	10	9	28	26	18	er	cooperative
seq3153_all_clean_seqs_gap0_no20_0.4	GACCAGGCGAGAGGATGTGGGTATGAGGGAGGAGCT	13	12	18	16	5	er	cooperative
seq3154_all_clean_seqs_gap0_no20_0.4	TCGGCGGATATGAAAAAAAGTCCGTGGTCACGTGCA	6	5	25	23	19	er	independent
seq3155_all_clean_seqs_gap0_no20_0.4	TTTACAGGAAATTACAGGGGTTAAACCAAACCACAA	7	6	31	29	24	er	ambiguous
seq3156_all_clean_seqs_gap0_no20_0.4	TCCACATCCTGCTCCTCGGGTTTGCGGCGAGGACTC	7	5	25	23	18	er	ambiguous
seq3157_all_clean_seqs_gap0_no20_0.4	ACACTGAGCTGAACGGAAATGTGGTTCTCACCTCAT	15	14	22	20	7	er	ambiguous
seq3158_all_clean_seqs_gap1_no20_0.4	TGAAGGAAGGGGGCTGTTTGCAGATAACCACAGCCT	5	4	28	26	23	er	cooperative
seq3159_all_clean_seqs_gap1_no20_0.4	AAGGCGGAGGAAGGGAAAATTGTGGTTGGGCAGAGG	9	8	23	21	14	er	cooperative
seq3162_all_clean_seqs_gap1_no20_0.4	AGGCCACCCCCTTCCTCCGCCCGCGGGTCGCAGCCT	13	11	24	22	11	er	independent
seq3164_all_clean_seqs_gap1_no20_0.4	AAAGAGGAAATCACATACCCGAAAACCACATGCACA	6	5	26	24	20	er	cooperative
seq3165_all_clean_seqs_gap1_no20_0.4	GACCAATGTAAACAAGGATGTGGGTTCTCCGGCCAC	16	15	21	19	5	er	cooperative
seq3166_all_clean_seqs_gap1_no20_0.4	TACAGGAACTTCCTGCGCGGCTGCTGTGGTTGCGAG	11	9	27	25	16	er	cooperative
seq3167_all_clean_seqs_gap1_no20_0.4	GCGCGGCCAGAGAAAGGATGTGGTATAGCAGAAAGT	16	15	21	19	5	er	cooperative
seq3168_all_clean_seqs_gap1_no20_0.4	AAACCCCAACTCAGAGGAAGCCACAGCTAGACAAGC	16	15	21	19	5	er	independent
seq3169_all_clean_seqs_gap1_no20_0.4	AGTGGCTACCACTTCCTTCTCTTACCACAGTTCCTT	14	12	25	23	11	er	cooperative
seq3170_all_clean_seqs_gap1_no20_0.4	TGCTTAGCGGGAAGTGCTTACACCACAAAACAAGAC	10	9	23	21	13	er	cooperative
seq3171_all_clean_seqs_gap1_no20_0.4	CCGCCGCGACACTTCCGGCGGCCACCACAGGGTATT	14	12	25	23	11	er	independent
seq3172_all_clean_seqs_gap1_no20_0.4	GTTCATCCAGGAAACCCCAACCCAGTGCCGCAGTAT	10	9	28	26	18	er	independent
seq3174_all_clean_seqs_gap1_no20_0.4	ACACCTCAGGAAGTGGCAGAGACCACAACAAGTCAG	9	8	23	21	14	er	cooperative
seq3175_all_clean_seqs_gap1_no20_0.4	TGGACGTAACACTCAGGAAGTGGTCAACCTTGCTGC	16	15	21	19	5	er	cooperative
seq3176_all_clean_seqs_gap1_no20_0.4	CTTCTCGCGGAAGCGGCACAAGCCGCAGTACAGCGC	9	8	23	21	14	er	independent
seq3178_all_clean_seqs_gap1_no20_0.4	GGGTTGGGTGCCGGATGCGGTGAGTGAGGTTCTCAT	13	12	18	16	5	er	cooperative
seq3179_all_clean_seqs_gap1_no20_0.4	TCTTGAGGGTCAGGATGTGGTGAGGCCAGAGAAGGC	13	12	18	16	5	er	cooperative
seq3180_all_clean_seqs_gap1_no20_0.4	GTGAGTCACTTCCTGACCATGTGGGTTTTTGGTACG	11	9	22	20	11	er	cooperative
seq3181_all_clean_seqs_gap1_no20_0.4	TCACTCCTCTTCCTTCCTGCCACCCACAGGGTCAGC	15	13	24	22	9	er	independent
seq3182_all_clean_seqs_gap1_no20_0.4	TTACCTTCCTGCTGCCACCAAAGCACCAAACCACCA	7	5	31	29	24	er	independent
seq3183_all_clean_seqs_gap1_no20_0.4	AGCCAGGAAATCCGCACCTACACAGCCCAACCACAG	6	5	31	29	25	er	independent
seq3184_all_clean_seqs_gap1_no20_0.4	AATGGGCTTGGTTTCCTGTGGGTTTGTAGCTTTGTA	14	12	19	17	5	er	independent
seq3185_all_clean_seqs_gap1_no20_0.4	ACTTACTTCCCGACGTCACAGCCACCGAAACCACAG	8	6	31	29	23	er	independent
seq3186_all_clean_seqs_gap1_no20_0.4	CCTTTACGTTTTCCTGTTGCGGGTTCTATCGCTCTG	12	10	20	18	8	er	cooperative
seq3187_all_clean_seqs_gap1_no20_0.4	AGGGCATTTCCTTTGGGGCTGGTGGTCACGGACAAC	9	7	23	21	14	er	independent
seq3188_all_clean_seqs_gap1_no20_0.4	GGGGCGGGGTCTCGGAAGCTGCGGCCTGAGGTGCCT	14	13	22	20	8	er	independent
seq3189_all_clean_seqs_gap1_no20_0.4	AGTAGGATGGGAGGAAGTGGTTTGTAAGAGGAGGAC	13	12	18	16	5	er	ambiguous
seq318_all_clean_seqs_gap0_no20_0.4	GTCTTCACATGTAGGGGAAGTGGGTTAGCGTAGGAG	16	15	21	19	5	er	cooperative
seq56_all_clean_seqs_gap0_no20_0.4	GTCTTCACATGTAGGGGAAGTGGGTTAGCGTAGGAG	16	15	21	19	5	er	independent
seq3190_all_clean_seqs_gap1_no20_0.4	GACTGCACTTCCTCTGCTTCGAGGTCGGTGGTTAGC	10	8	29	27	19	er	independent
seq3191_all_clean_seqs_gap1_no20_0.4	TCCTCCGGATGCCCAGCGGCTGCTGAGATACCGCGG	7	6	31	29	24	er	independent
seq3192_all_clean_seqs_gap1_no20_0.4	GCAGCTCTGGCAGGATGCGGTTAAATATGTAGCCAC	13	12	18	16	5	er	cooperative
seq3193_all_clean_seqs_gap1_no20_0.4	GCTTCTGAGGAAGTGCGTTTTGTGGGTAGGTGGAGT	9	8	23	21	14	er	cooperative
seq3194_all_clean_seqs_gap1_no20_0.4	TAGCCACTAACCGGAAACGTTAAACCACAGCTCCGT	13	12	25	23	12	er	cooperative
seq3196_all_clean_seqs_gap1_no20_0.4	GCCCAGTTCTCGCATCCGGTCTGCGGCGCGCTCGGG	15	13	24	22	9	er	independent
seq31_all_clean_seqs_gap0_no20_0.4	TGCCTTCTACTCCGGAACTCAGACCGCTGCCTTCTA	14	13	24	22	10	er	independent
seq321_all_clean_seqs_gap0_no20_0.4	GGCCGGAAAGGGTCTTGAGAGGAGGTGGTTGCCTTA	5	4	26	24	21	er	independent
seq322_all_clean_seqs_gap0_no20_0.4	ATGACAGGGACAACTTCCTAGTGGTATGGCACCACC	16	14	22	20	6	er	independent
seq323_all_clean_seqs_gap0_no20_0.4	TTCAGGTGACTTCCGGCCGGACCGCTGAGGACGCGG	12	10	22	20	10	er	independent
seq85_all_clean_seqs_gap0_no20_0.4	TTCAGGTGACTTCCGGCCGGACCGCTGAGGACGCGG	12	10	22	20	10	er	independent
seq328_all_clean_seqs_gap0_no20_0.4	AGATCAACTTCCACATCCGGTGGTAACAGGGCCCTA	16	14	21	19	5	er	independent
seq32_all_clean_seqs_gap0_no20_0.4	GAGTGCCGTTTCCCCCGCTCACCGCGGGCTAGGGAG	11	9	22	20	11	er	independent
seq330_all_clean_seqs_gap0_no20_0.4	AGCCTCCCGGACGCCGTCGCCCCCACACACGCCCGC	9	8	23	21	14	er	independent
seq331_all_clean_seqs_gap0_no20_0.4	TTTACGGGATGTAGGCGGCGGCGGCGGTAGTGGTAG	7	6	25	23	18	er	independent
seq332_all_clean_seqs_gap0_no20_0.4	GGACAAAACATCATAGGAAGTGGGTTTTGGGGTGAG	16	15	21	19	5	er	independent
seq635_all_clean_seqs_gap0_no20_0.4	GGACAAAACATCATAGGAAGTGGGTTTTGGGGTGAG	16	15	21	19	5	er	cooperative
seq336_all_clean_seqs_gap0_no20_0.4	CTTCAAAGTCAGGAAACCGTTAAACCACACTGCATC	12	11	25	23	13	er	cooperative
seq696_all_clean_seqs_gap0_no20_0.4	CTTCAAAGTCAGGAAACCGTTAAACCACACTGCATC	12	11	25	23	13	er	cooperative
seq342_all_clean_seqs_gap0_no20_0.4	ACGTTTCGGGGTTTCCGGGCCAGCGGTTTCGGGCGC	14	12	24	22	10	er	cooperative
seq345_all_clean_seqs_gap0_no20_0.4	GACAACCCCATCCTGCGCTCGCCCGCGGTGTCTCGG	11	9	26	24	15	er	independent
seq348_all_clean_seqs_gap0_no20_0.4	TAGGCAGGCAGGATGTGCCTATAAGCCACATGAATG	11	10	26	24	15	er	independent
seq349_all_clean_seqs_gap0_no20_0.4	AGCAGCTTCCCGTCTGAGGTGAAGACAGCCCGCAGC	8	6	30	28	22	er	independent
seq350_all_clean_seqs_gap0_no20_0.4	CAGAAACATCCCTCCTGCCGCCGCTTTGTGGTACCA	9	7	29	27	20	er	independent
seq351_all_clean_seqs_gap0_no20_0.4	CTGTCCGCGACATCCGGGACCTGCGGGACCGCCGAT	13	11	24	22	11	er	independent
seq353_all_clean_seqs_gap0_no20_0.4	CCCGCTGTCACTTCCTGCTTCCCTCCCGCACACGTG	13	11	26	24	13	er	independent
seq354_all_clean_seqs_gap0_no20_0.4	GCGCCCGGAAGGAAGGCTGGGGTAGGTTGTGGTTTC	7	6	30	28	23	er	cooperative
seq355_all_clean_seqs_gap0_no20_0.4	AAAGGGAAGTTCGCGGGAGGTCAAAACCACCGGGGC	5	4	27	25	22	er	ambiguous
seq358_all_clean_seqs_gap0_no20_0.4	AACAAACCGGATGGGGTTCCCACCCGCAATCTTGTC	9	8	24	22	15	er	cooperative
seq360_all_clean_seqs_gap0_no20_0.4	AACCTCCGACTTCCGGCCGCGCAGCGGTGGGCTGAG	12	10	25	23	13	er	independent
seq362_all_clean_seqs_gap0_no20_0.4	AAATCACATTTCCCAGAGTGCACCGCGACGGCAGGG	11	9	23	21	12	er	ambiguous
seq363_all_clean_seqs_gap0_no20_0.4	CGAGTCAGGAAATCACAGCTCTGCGGGTGGGCTCCT	8	7	24	22	16	er	independent
seq365_all_clean_seqs_gap0_no20_0.4	TGAGGAAGTGTAAGTCACAATAAGAAGCCACATATA	4	3	28	26	24	er	ambiguous
seq366_all_clean_seqs_gap0_no20_0.4	CACTCCCCGCATCCGGTCTGCGGCGCGCTCGGGGCC	12	10	21	19	9	er	independent
seq367_all_clean_seqs_gap0_no20_0.4	CCCACAGGAAATCCCCTGGTCTGTGGCGCCTCTGAT	7	6	24	22	17	er	independent
seq368_all_clean_seqs_gap0_no20_0.4	AACACTATTTCCTTTCTTGCTGCCCACATTTTAACA	10	8	24	22	14	er	independent
seq369_all_clean_seqs_gap0_no20_0.4	AAAACGCGGAAATACGGTGGCTGCGGCCCGCGGGCA	8	7	24	22	16	er	independent
seq36_all_clean_seqs_gap0_no20_0.4	GCCTCCTCAGGAAATTGCCCAAAATAGCCACATGTC	10	9	28	26	18	er	independent
seq371_all_clean_seqs_gap0_no20_0.4	GACCTGACAACATCCTGGCGCAGTGGGTTGGCCCTG	13	11	24	22	11	er	independent
seq372_all_clean_seqs_gap0_no20_0.4	CCCTGGACGGGAAGCGGCGGCCAGATCCGCAAGCCC	10	9	27	25	17	er	independent
seq373_all_clean_seqs_gap0_no20_0.4	AGTGGGGCCCCAGGATGTGTTTTGGTTTTGCAAGGT	13	12	23	21	10	er	independent
seq374_all_clean_seqs_gap0_no20_0.4	CCATTTCCCCCATCACTTTGAATTGTGGTTCTTCTC	6	4	26	24	20	er	independent
seq375_all_clean_seqs_gap0_no20_0.4	CCAGCCCAGGAAACAAGGAACCCCAAAGCCACAGGA	9	8	29	27	20	er	independent
seq376_all_clean_seqs_gap0_no20_0.4	AGGGTGTGGAGGAAGTGGCTTACAACCACTTTGTCT	11	10	26	24	15	er	independent
seq377_all_clean_seqs_gap0_no20_0.4	CCATCCAGGAAGCTTATGGTGCAACCGCAGTGTGCC	8	7	25	23	17	er	cooperative
seq379_all_clean_seqs_gap0_no20_0.4	GCTGGGGCAGGAAGCTTCTAGGCCACAGACAGGACG	10	9	23	21	13	er	independent
seq37_all_clean_seqs_gap0_no20_0.4	TGCTTCCCGTCCGTGTCGCGGCCCTGCGGTTGGCGG	5	3	27	25	22	er	cooperative
seq381_all_clean_seqs_gap0_no20_0.4	AGAGTCTTTTTTCCTGAGCGTTTGCGGTTTTGACTT	12	10	25	23	13	er	cooperative
seq383_all_clean_seqs_gap0_no20_0.4	AACCAAGAGGATTTCCTGCCCACACACTCAGCGTCT	14	12	20	18	6	er	independent
seq384_all_clean_seqs_gap0_no20_0.4	GGGGAACGGAAGCTGCTGTCGTTACTGGCGGTTGTA	8	7	29	27	21	er	independent
seq386_all_clean_seqs_gap0_no20_0.4	GTACGCTCTTCACTTCCCGTACCCGCGCCCGGCAGG	15	13	23	21	8	er	independent
seq387_all_clean_seqs_gap0_no20_0.4	CATTTACAGAAAAGGAAACCGCAAGTTTGAGCAAGT	14	13	19	17	5	er	cooperative
seq388_all_clean_seqs_gap0_no20_0.4	GGAGCAAGGATGACAGGATGTGGCTTAGGGGGAGGC	16	15	21	19	5	er	ambiguous
seq390_all_clean_seqs_gap0_no20_0.4	TGGCTGGGCAGGAAGGCCTGTGGCTTACGGTTCCTG	11	10	21	19	10	er	independent
seq391_all_clean_seqs_gap0_no20_0.4	GATACAGTGCTCAGGAAACCACATGAAACCAGAGTA	14	13	19	17	5	er	independent
seq394_all_clean_seqs_gap0_no20_0.4	AGAGCCACATCCCGCGCAGAGGACCGCGGCGACCGG	10	8	24	22	14	er	independent
seq395_all_clean_seqs_gap0_no20_0.4	GGAGGGGAGCAGGAAGCTGAGGTTTTGTGAGTCAGA	12	11	20	18	8	er	independent
seq396_all_clean_seqs_gap0_no20_0.4	GAAAGACAGGATGTGGGATAGATCTCAACCACCTTT	9	8	29	27	20	er	cooperative
seq397_all_clean_seqs_gap0_no20_0.4	GAAAGCTGCACTATTTCCTGAGGTTAGAGGTTTAAA	16	14	21	19	5	er	independent
seq398_all_clean_seqs_gap0_no20_0.4	ATGGGGAACGGGAAATACGGCGGGAACCACAATCGC	11	10	27	25	16	er	cooperative
seq39_all_clean_seqs_gap0_no20_0.4	AAATCCACTCAGAGGAAACCACAGGCCTGGCCCAGC	14	13	19	17	5	er	cooperative
seq3_all_clean_seqs_gap0_no20_0.4	CAGGCCTGTGATTTCCTCTGAGTGGTTTTCTTGGCC	14	12	23	21	9	er	independent
seq400_all_clean_seqs_gap0_no20_0.4	GCTAAGGTGAAAGGAAGTGGGTTTTGTCTTTTTTTT	13	12	18	16	5	er	independent
seq401_all_clean_seqs_gap0_no20_0.4	GCACTGTAGGCAGGATGTGGGCAGGGGAAACTCAGG	13	12	18	16	5	er	cooperative
seq403_all_clean_seqs_gap0_no20_0.4	AGGTTGAAAGCACTTCCGCTGCGGCCCCCGTAGGAA	15	13	22	20	7	er	independent
seq404_all_clean_seqs_gap0_no20_0.4	CCTCCTGGGAACTTCCTGCGGGGGCCGAAGCTGAAG	14	12	19	17	5	er	independent
seq405_all_clean_seqs_gap0_no20_0.4	CCTCCCGACCGGAAGCCCCGCCACAGAGCGGGTTGT	11	10	21	19	10	er	independent
seq406_all_clean_seqs_gap0_no20_0.4	AACAACAGGATGCTCTCTAGTCTAACAGTGGTAACA	8	7	29	27	21	er	independent
seq408_all_clean_seqs_gap0_no20_0.4	CCGCCCTCCACCGAGTTCCGGCCACAGAGCGGGCCC	17	15	22	20	5	er	independent
seq411_all_clean_seqs_gap0_no20_0.4	CTCGCCCCATTTCCCGTAAATATCAGCCACAGACCA	12	10	27	25	15	er	independent
seq412_all_clean_seqs_gap0_no20_0.4	GTGCCTTTTCATGTGGGATGTGGCTTCAAGGAGACC	16	15	21	19	5	er	independent
seq413_all_clean_seqs_gap0_no20_0.4	GCGATCGGAGCGGAAGTGGAGCTACCGCCACCGCCG	12	11	25	23	13	er	independent
seq414_all_clean_seqs_gap0_no20_0.4	CGAGCTCGCAAGAGGAAACCGCGGCGCGGAGGCAGC	14	13	19	17	5	er	cooperative
seq415_all_clean_seqs_gap0_no20_0.4	GCGGAGTGTTACGTAGGAAGTGGTTGTGACGTCATT	16	15	21	19	5	er	cooperative
seq416_all_clean_seqs_gap0_no20_0.4	GGGAACTGGGGAAGGGGATGTGGTAACCAGAACCAC	16	15	21	19	5	er	cooperative
seq417_all_clean_seqs_gap0_no20_0.4	CACCTAAAGCCATTGGGATGTGGTTTCTCTTTTTCA	16	15	21	19	5	er	cooperative
seq418_all_clean_seqs_gap0_no20_0.4	CTGTCAGGATGTTGGCTTGTGAGCCCACAATCCTCT	7	6	25	23	18	er	independent
seq419_all_clean_seqs_gap0_no20_0.4	CCCACTTCCTGTCCCTGCATGCTGTGGGGCAGGCAG	7	5	25	23	18	er	independent
seq41_all_clean_seqs_gap0_no20_0.4	CTGTTCTCATCCGCCCGCTCTGAGTCACCCACACCT	10	8	29	27	19	er	independent
seq422_all_clean_seqs_gap0_no20_0.4	CCGAAGAGGAAGCTCCACAGGACCTCCGCGGTCAGC	8	7	29	27	21	er	cooperative
seq423_all_clean_seqs_gap0_no20_0.4	ACAAAACAAACACATCCCCCAAACCGCCAAACTACA	15	13	24	22	9	er	independent
seq424_all_clean_seqs_gap0_no20_0.4	CCCTTTTCCTTCCGGCCTGTGCGGCTTATAAGATCT	11	9	22	20	11	er	independent
seq425_all_clean_seqs_gap0_no20_0.4	GAGAATGAAGAGGAAATGTGGGGACAGACAGAACTG	12	11	19	17	7	er	independent
seq428_all_clean_seqs_gap0_no20_0.4	ACTTGACTTCCTGTGGGGTGTGTGGTGTCTGCACTT	9	7	23	21	14	er	independent
seq429_all_clean_seqs_gap0_no20_0.4	TGCCCCCTCCCCCTTCCGCTGTGGCCACCGGCTTTG	15	13	22	20	7	er	independent
seq430_all_clean_seqs_gap0_no20_0.4	TTATTTCCTCTTTTTTTTTTTTTTTTTGGTTTTGCT	6	4	27	25	21	er	ambiguous
seq434_all_clean_seqs_gap0_no20_0.4	CCGTGTCAGTGAGGATGTGGGCTGCCGGGCTGGGCG	13	12	18	16	5	er	independent
seq436_all_clean_seqs_gap0_no20_0.4	CCGGGCCTCCAGACGGAACTGTGGGCGAGGGGAGGG	15	14	22	20	7	er	ambiguous
seq437_all_clean_seqs_gap0_no20_0.4	AACAAAGAGAGAGGAAGTGGGTTGGGCGGGGGGGGT	13	12	18	16	5	er	independent
seq438_all_clean_seqs_gap0_no20_0.4	ATCAGAGCGGAAATCTCAGTCTTGTGTGGGGACCTG	9	8	27	25	18	er	independent
seq439_all_clean_seqs_gap0_no20_0.4	CGGCAGGGAAGCAGGAAACCGCGAGTGGAGAAAGGG	14	13	19	17	5	er	cooperative
seq440_all_clean_seqs_gap0_no20_0.4	CCTCACAGGGACTTCCTTCCCCGCGGTTCAGGAATC	14	12	24	22	10	er	independent
seq441_all_clean_seqs_gap0_no20_0.4	GGGGAAGAGGGGAGGATGTCTGAGGTTTTAATTGTA	14	13	23	21	9	er	cooperative
seq445_all_clean_seqs_gap0_no20_0.4	AGCGGCTTCCTGCTGGGCTTTTGCACTCCCCACAAC	8	6	30	28	22	er	independent
seq446_all_clean_seqs_gap0_no20_0.4	TCCGGTCTCGGGACGTCCGGCCCCGCACACTCAGCA	16	14	23	21	7	er	independent
seq447_all_clean_seqs_gap0_no20_0.4	CGAAGCCGGAAATGCTGAGTGTGCGGGGCCGAACGT	8	7	24	22	16	er	independent
seq448_all_clean_seqs_gap0_no20_0.4	TAAGTGCAGGAAACGGCTGTGTGGGTGTCAGTGATT	9	8	22	20	13	er	independent
seq449_all_clean_seqs_gap0_no20_0.4	ACCAGAGAAGGAAATACACAGTAAACCCACTGCCTC	10	9	27	25	17	er	ambiguous
seq44_all_clean_seqs_gap0_no20_0.4	ATTTTTCCTTCCTTCTCCCGTCCCCGCAGAGTGCAA	10	8	24	22	14	er	independent
seq450_all_clean_seqs_gap0_no20_0.4	AGAAGGAACTACACAGGAAACCCACTGCCTCGATGG	16	15	22	20	6	er	independent
seq451_all_clean_seqs_gap0_no20_0.4	GCACGCCATCGAGGAAGTGGGTTTACTGTGTATTTC	13	12	18	16	5	er	independent
seq452_all_clean_seqs_gap0_no20_0.4	GTCCCCTCCCCAGGATGTGGCCACCCGCTAGAGCAT	13	12	18	16	5	er	cooperative
seq453_all_clean_seqs_gap0_no20_0.4	GACGGCCCCAGCGGAAGTGGTTGCCTTGGTTTGCGC	13	12	18	16	5	er	independent
seq456_all_clean_seqs_gap0_no20_0.4	ACCTCAGGTACCGGAAGACCACAATTCCCAGGAGTC	13	12	19	17	6	er	independent
seq459_all_clean_seqs_gap0_no20_0.4	AAAACAACTTCCTTCCCCTCTCTCTCCACCACAGTC	10	8	29	27	19	er	independent
seq463_all_clean_seqs_gap0_no20_0.4	GTAAAGGGCGCCCGGAAAATGTGGGAACGGCTAGAG	14	13	22	20	8	er	independent
seq464_all_clean_seqs_gap0_no20_0.4	AGCTTTCCTTTTCCGGTTGCGGCGCCGCGCGTTGAT	12	10	20	18	8	er	independent
seq465_all_clean_seqs_gap0_no20_0.4	TCCATCCTGATTCTCTCGGACTTTTCAACCGCCCGG	5	3	29	27	24	er	independent
seq466_all_clean_seqs_gap0_no20_0.4	CTCCCCCCACGACTTCCCTCTGTGGCCCCGGGCCGC	15	13	23	21	8	er	independent
seq467_all_clean_seqs_gap0_no20_0.4	TCGGTGAAGGACGGAAGATGATAGCCACATTTCTTC	13	12	25	23	12	er	independent
seq469_all_clean_seqs_gap0_no20_0.4	GAAGTCACTCAGGGAGGAAACCACAGGGCCGGTCCG	16	15	21	19	5	er	cooperative
seq46_all_clean_seqs_gap0_no20_0.4	TTGTCAGATGGCGAAGGAAACCGCGAAATTCGCCAT	16	15	21	19	5	er	cooperative
seq470_all_clean_seqs_gap0_no20_0.4	AGCACGCCGGGAAATGGAGTCTCAGGTGGTTTTTAA	10	9	27	25	17	er	independent
seq471_all_clean_seqs_gap0_no20_0.4	TCAGTGCACTCGGATGTTGGCCGCAGTTGGGGTTAT	12	11	21	19	9	er	independent
seq472_all_clean_seqs_gap0_no20_0.4	AGGCCGCTTCCTCCCACATGAAACCGCAGGCTTCGG	9	7	24	22	15	er	cooperative
seq473_all_clean_seqs_gap0_no20_0.4	CCACGTCCACAAAGGAAACCGCGGCCTGCCCGGGGA	14	13	19	17	5	er	cooperative
seq474_all_clean_seqs_gap0_no20_0.4	CTCTGCCCGCTTCCGCTGGCGGTACCTCAGAGCCGC	12	10	20	18	8	er	independent
seq477_all_clean_seqs_gap0_no20_0.4	AGGAGCCGGAAGTCCCGCCCACGCACCCCCCGCAGG	8	7	30	28	22	er	independent
seq478_all_clean_seqs_gap0_no20_0.4	AGCGGCAGTAGAGGAAGCCTTCGCGGTCCATGGCCA	13	12	24	22	11	er	ambiguous
seq479_all_clean_seqs_gap0_no20_0.4	GTTCCTAGGCAGGCAGGATGTGGCTATAAGCTACAT	16	15	21	19	5	er	independent
seq480_all_clean_seqs_gap0_no20_0.4	TATTGTGTACTTCCCCTTCATGTTGTGGTTGGCTTT	12	10	26	24	14	er	independent
seq482_all_clean_seqs_gap0_no20_0.4	GGTGCCTGGGGAGGATGTGGGCTGACTGGGAGGGGT	13	12	18	16	5	er	cooperative
seq483_all_clean_seqs_gap0_no20_0.4	AGTTTCTCCAGGAAGCGCTGAGGTTTTCTCAGAAGT	11	10	21	19	10	er	independent
seq484_all_clean_seqs_gap0_no20_0.4	ACTCCGCCCCTTCCGCCTGGCGGTTCCACTTCTCGG	12	10	21	19	9	er	independent
seq485_all_clean_seqs_gap0_no20_0.4	CCAGGCGGAAGCGGCCGGGAGTAGCGCTGCGGTTGG	7	6	30	28	23	er	cooperative
seq487_all_clean_seqs_gap0_no20_0.4	AAAACCTTGTTGAAAGGATGTGGCTTAGCGAGAGGT	16	15	21	19	5	er	independent
seq488_all_clean_seqs_gap0_no20_0.4	CTGAGACCTCGGGCAGGATGTGGCTTCCCCAGAGTT	16	15	21	19	5	er	cooperative
seq489_all_clean_seqs_gap0_no20_0.4	CCAGGGGCACACCGGAACCCACACCTGAAATCACAG	14	13	19	17	5	er	independent
seq48_all_clean_seqs_gap0_no20_0.4	CCATTCCCGGGCTTCCGCGGTGTCCCCACCCCCTAA	14	12	18	16	4	er	independent
seq490_all_clean_seqs_gap0_no20_0.4	GACACCCCACACCGGAAACCTCAGACAGTCCTCAGC	14	13	19	17	5	er	independent
seq491_all_clean_seqs_gap0_no20_0.4	TGACGGCCAGGAAGCCTGAAGCCGCAGGGGCCGCCG	10	9	22	20	12	er	cooperative
seq492_all_clean_seqs_gap0_no20_0.4	GAAACGTCACCCAGAGGAAACCCACAAGGGGCGTGG	16	15	22	20	6	er	cooperative
seq493_all_clean_seqs_gap0_no20_0.4	CCGGGACCGGAAGAGGGAGCCGTGGTTGCTGGAACT	9	8	23	21	14	er	independent
seq495_all_clean_seqs_gap0_no20_0.4	CAGTGTTCTTGGGAAATGTGGTCCACAGCCTCCGCT	12	11	19	17	7	er	independent
seq497_all_clean_seqs_gap0_no20_0.4	CCGAGACACATGGGATGTGGGCGGGAGGAGGAATTG	13	12	18	16	5	er	independent
seq498_all_clean_seqs_gap0_no20_0.4	GTGCTGAGCAGCTTCCCGTCTGCGGTGAAGACAGCC	14	12	23	21	9	er	cooperative
seq49_all_clean_seqs_gap0_no20_0.4	GTCACCATTTCCGGGCCTCCGCGGTGTCCCCACCCC	10	8	22	20	12	er	independent
seq500_all_clean_seqs_gap0_no20_0.4	CTGGTTTCATTTCCGGGTGCGGCTTCTGTCATAAAG	12	10	20	18	8	er	independent
seq503_all_clean_seqs_gap0_no20_0.4	AACAACAAACATCCCAGGAACCACAGTGGGACAGGA	12	10	21	19	9	er	independent
seq506_all_clean_seqs_gap0_no20_0.4	CCATTTCCTGATTCTAATGTTCATCAACCACTTTTG	6	4	28	26	22	er	independent
seq507_all_clean_seqs_gap0_no20_0.4	TCAGCTGACACAGGAAGTGGTAAAGCTATTATCTGT	13	12	18	16	5	er	cooperative
seq508_all_clean_seqs_gap0_no20_0.4	TTTTCTTTCCTAGGAAGTGGTTGCTGGGTTCTGAGG	13	12	18	16	5	er	independent
seq509_all_clean_seqs_gap0_no20_0.4	TGTGTAAGAGGAAACACCAAAACCACAAATATGAAA	10	9	23	21	13	er	cooperative
seq50_all_clean_seqs_gap0_no20_0.4	TCCACAGCCGGTTCCGGCCGGTTCCCACAAGCCCCT	13	11	25	23	12	er	independent
seq511_all_clean_seqs_gap0_no20_0.4	CAGGGTGTCGGCTTCCGGCGGTTGCCCACTTTCGGC	14	12	19	17	5	er	independent
seq512_all_clean_seqs_gap0_no20_0.4	TGTGAGAAGCCGGATCCTGTGGTGACCCAGTGGCCT	12	11	20	18	8	er	independent
seq513_all_clean_seqs_gap0_no20_0.4	CCACTGCCGGAAGGGGAACTGTGGGGGTGCGCGAGT	9	8	22	20	13	er	independent
seq514_all_clean_seqs_gap0_no20_0.4	CCTGAGCGCCCGGAAGGAAGGCTGTGGTAGGTTGTC	12	11	25	23	13	er	cooperative
seq515_all_clean_seqs_gap0_no20_0.4	CCGCGAGCCGTCACTTCCTGTGGGCTGGGCCGAGCC	16	14	21	19	5	er	ambiguous
seq516_all_clean_seqs_gap0_no20_0.4	GGGAGGTGTCCAGGAAGTGGTTGGAGAGTCTGGTCT	13	12	18	16	5	er	independent
seq517_all_clean_seqs_gap0_no20_0.4	AGTCAAACAGGATGTGGCTGGGGAGGCGGTTGTCAC	10	9	27	25	17	er	independent
seq518_all_clean_seqs_gap0_no20_0.4	GCAGAGAGGAGGGGATGTGGTTTCACAGCTTGCTCC	13	12	18	16	5	er	cooperative
seq519_all_clean_seqs_gap0_no20_0.4	GGCGAGGCTGAGAGGAAACCACACTCTCACTGGGGT	14	13	19	17	5	er	independent
seq51_all_clean_seqs_gap0_no20_0.4	GAAGCCAGGAAATGGTGCGTGTGCGGGGCCGGGCGC	8	7	24	22	16	er	independent
seq520_all_clean_seqs_gap0_no20_0.4	ATATATCACCCCTTCCTTGCAAAACCACAAGACCAA	14	12	25	23	11	er	cooperative
seq522_all_clean_seqs_gap0_no20_0.4	GTGCGGCGGGAAACGCGTTCCCCGGCAACCGCGCCC	9	8	29	27	20	er	independent
seq523_all_clean_seqs_gap0_no20_0.4	TGCAGTCGTGAAAAAGGAAGTGGTTAAAGTGGCTAC	16	15	21	19	5	er	cooperative
seq524_all_clean_seqs_gap0_no20_0.4	AGCACCCCAGGAAACCATCGCCTCAGCCCACATATT	10	9	28	26	18	er	independent
seq525_all_clean_seqs_gap0_no20_0.4	CCCAGGCTTCCGGGTTGAATATGTGGGCTGAGGCGA	9	7	24	22	15	er	independent
seq526_all_clean_seqs_gap0_no20_0.4	TCCCCACACTTCCGGCCCCGCCCGCACAGCCGCACC	11	9	22	20	11	er	independent
seq527_all_clean_seqs_gap0_no20_0.4	GCAATGCCGCTACCGGAAGTGCGGGTCGCGCTCCCG	15	14	22	20	7	er	independent
seq528_all_clean_seqs_gap0_no20_0.4	GGACGCCGCCGGAAGCGCGACCCGCACTCCCGGTAG	11	10	22	20	11	er	independent
seq530_all_clean_seqs_gap0_no20_0.4	GAAGGAAGTGGAGACAGTAAGGGGAAACCACAAACC	4	3	28	26	24	er	cooperative
seq532_all_clean_seqs_gap0_no20_0.4	TGCTCAGAAGGGCATCCGGTTGCGGAGAAGGTACAC	15	13	23	21	8	er	independent
seq533_all_clean_seqs_gap0_no20_0.4	CTTAAATGGGAAATGTAGGTGTGGTTAAGTCACAAA	9	8	22	20	13	er	independent
seq536_all_clean_seqs_gap0_no20_0.4	CGCCCACCACTTCCTGCTGGCGGTCGGCAAGCGTTG	12	10	21	19	9	er	cooperative
seq537_all_clean_seqs_gap0_no20_0.4	TGCAAGAGGAAGCTGGGGTTTGTGGTTCATGTTTTG	8	7	23	21	15	er	cooperative
seq538_all_clean_seqs_gap0_no20_0.4	CAAAGCAACCCAAGGGGATGTGGTCACTGGGGTGAG	16	15	21	19	5	er	cooperative
seq539_all_clean_seqs_gap0_no20_0.4	TTACCCCAGGAAAAGCCTCCTCACCGCAGTGACCAG	9	8	24	22	15	er	independent
seq542_all_clean_seqs_gap0_no20_0.4	ACTGAACAAACCGGATGTGGTTCCCACCTGCAATCT	13	12	18	16	5	er	independent
seq544_all_clean_seqs_gap0_no20_0.4	GACAGAGGAAACTAGGTGTGACAACCACAAACAGCT	7	6	25	23	18	er	independent
seq545_all_clean_seqs_gap0_no20_0.4	CTGCTAGCGGAAGCAGCCAAGCCCACAGGCTCCAGG	9	8	23	21	14	er	independent
seq546_all_clean_seqs_gap0_no20_0.4	GCAGGCGTGCGCTTCCGCTCCAACCCGCGCACTTCG	14	12	25	23	11	er	independent
seq547_all_clean_seqs_gap0_no20_0.4	CCCGTTCTCCGGAAGTGCGCGGGTTGGAGCTGAAGC	11	10	20	18	9	er	independent
seq548_all_clean_seqs_gap0_no20_0.4	CCCCTTCCCGTTCTCCGAAAGTGCGCGGGTTGGAGC	6	4	26	24	20	er	ambiguous
seq54_all_clean_seqs_gap0_no20_0.4	CATGAGAAACATCCTGCCCAACCACCTGACTACAAG	12	10	22	20	10	er	independent
seq550_all_clean_seqs_gap0_no20_0.4	CTCGTGGGTGCCGGAAGTGGAGGCGGTTGGTGGGGT	13	12	24	22	11	er	independent
seq551_all_clean_seqs_gap0_no20_0.4	GCTATCCCCGCCCCTTCCTGTGGGCTGGCGCCCGAT	16	14	21	19	5	er	independent
seq552_all_clean_seqs_gap0_no20_0.4	CTGCGCTTCCGCTTCACCCGGAGTACAGCGGTCCTG	8	6	29	27	21	er	independent
seq554_all_clean_seqs_gap0_no20_0.4	AATCATCAGGGAAATGCAAATCAAAACCACAATCAG	10	9	27	25	17	er	cooperative
seq556_all_clean_seqs_gap0_no20_0.4	CCTGTCTGCTTCCGCCCGGCTTCGGCCCACAGTCAA	11	9	27	25	16	er	independent
seq558_all_clean_seqs_gap0_no20_0.4	CCAGCAGCACATCCCCCTTCTTCGTCCCGCAGAGGG	12	10	27	25	15	er	independent
seq559_all_clean_seqs_gap0_no20_0.4	TCAAGAAAACAGGAAACTCTCAAAACCAAGTTCTGA	12	11	26	24	14	er	independent
seq55_all_clean_seqs_gap0_no20_0.4	GCGCGGACTCCGGGAAGCTGAGCGGTAAAGACCGTG	13	12	23	21	10	er	ambiguous
seq560_all_clean_seqs_gap0_no20_0.4	GGCCCAGGAAAGAGGCAGGGGTGCGGTTTCCCTCCG	7	6	24	22	17	er	cooperative
seq561_all_clean_seqs_gap0_no20_0.4	CCTGACTTCCTCCTCCCCCTCCCGCCACAATTCCGC	8	6	25	23	17	er	independent
seq564_all_clean_seqs_gap0_no20_0.4	CCAGATTAGGAAACCCACCCGGCCCACAAAAAGCGG	9	8	24	22	15	er	ambiguous
seq565_all_clean_seqs_gap0_no20_0.4	ACCACCCCCCGTTTCCTCCGAAGTGGTTGGTGCCTT	14	12	24	22	10	er	independent
seq567_all_clean_seqs_gap0_no20_0.4	TCGGAGACGGCGAAAGGAAACCGCAAGGAGGCCACC	16	15	21	19	5	er	cooperative
seq568_all_clean_seqs_gap0_no20_0.4	TGGAAGGCCGGAAAAGGTTTACCACCACACTCCGGT	10	9	22	20	12	er	cooperative
seq569_all_clean_seqs_gap0_no20_0.4	TAGACTAACAGGGGAGGAAGTGGGTTGCAAGCCGTG	16	15	21	19	5	er	independent
seq571_all_clean_seqs_gap0_no20_0.4	CTGGGCTCGCCAGGCGGAAGTGGTTGGAGACTGCGT	16	15	21	19	5	er	independent
seq572_all_clean_seqs_gap0_no20_0.4	CAGCCCTCTTCCTGCCTGTCTGTGGCTGGTGAGGTT	10	8	23	21	13	er	independent
seq574_all_clean_seqs_gap0_no20_0.4	AGTACAAAGGGGAAATGTCTCTTGGTGGTTGATAAG	11	10	26	24	15	er	independent
seq576_all_clean_seqs_gap0_no20_0.4	GCCTGAAGCAGAGGATGTGGCTTCTGGCCCTCCCCT	13	12	18	16	5	er	independent
seq577_all_clean_seqs_gap0_no20_0.4	AACTCTGTGCAGAGGAAACCACCCAGCACGCAGCGG	14	13	19	17	5	er	independent
seq579_all_clean_seqs_gap0_no20_0.4	GGCTGACTTGCTGGCTTCCTCCCACAACTTTCGGGT	17	15	22	20	5	er	independent
seq580_all_clean_seqs_gap0_no20_0.4	TTGGAGACACACAAAGGATGTGGGCTGTGCGTGTGT	16	15	21	19	5	er	independent
seq581_all_clean_seqs_gap0_no20_0.4	AAATCACATACCCGGAAACCACATGCACAGAAGTGG	14	13	19	17	5	er	cooperative
seq582_all_clean_seqs_gap0_no20_0.4	AGGTTTTGAAAGAGGAAACCACATACCCGAAAACCA	14	13	19	17	5	er	ambiguous
seq583_all_clean_seqs_gap0_no20_0.4	CTTCTTTCCAGAGGATGTGGCTTCAGCGGGAGAGCT	13	12	18	16	5	er	cooperative
seq587_all_clean_seqs_gap0_no20_0.4	GCCGGTGAGGGCGGAAGTGGTAAGACTGACGTGTCC	13	12	18	16	5	er	independent
seq588_all_clean_seqs_gap0_no20_0.4	CTTCCCTTGCCCCGGAAAAGGGCGGTAAGAGGGAGC	14	13	23	21	9	er	independent
seq589_all_clean_seqs_gap0_no20_0.4	TTCTTCCCCCTTCCGGTCGCTGAGTGGTTGAGGCCG	12	10	25	23	13	er	independent
seq590_all_clean_seqs_gap0_no20_0.4	AGCGTTGTCTTCCGGCCTCAACCACTCAGCGACCGG	11	9	22	20	11	er	independent
seq592_all_clean_seqs_gap0_no20_0.4	CTCTTCCGCTCAGTCATCCTCAGAGGTGGTAAGACT	5	3	27	25	22	er	independent
seq593_all_clean_seqs_gap0_no20_0.4	TGGAACACTGCAAAAGGAAACCCACAGTCACCACGG	16	15	22	20	6	er	independent
seq597_all_clean_seqs_gap0_no20_0.4	GCAAGGTGGAGAGGAGGATGTGGCTTACCAGCAATT	16	15	21	19	5	er	independent
seq598_all_clean_seqs_gap0_no20_0.4	GATGGGCGAGTCAGGAAACCACAGCTCTGAGGGTGG	14	13	19	17	5	er	cooperative
seq599_all_clean_seqs_gap0_no20_0.4	GAAGCAGACAGGAAGTGGGTCTGAGCGGTGGAGGGA	11	10	26	24	15	er	independent
seq59_all_clean_seqs_gap0_no20_0.4	TGAATCATCCTGAGTTACCCGTTCTGTAACCGCCCC	8	6	30	28	22	er	independent
seq5_all_clean_seqs_gap0_no20_0.4	GAACCCCAAGTTCCGGCTGGCACTGCGGCGGAGCCT	12	10	26	24	14	er	independent
seq600_all_clean_seqs_gap0_no20_0.4	CCCACTTCCTGTCTGCTTCCCTCCACCGCTCAGACC	7	5	26	24	19	er	independent
seq602_all_clean_seqs_gap0_no20_0.4	AAGCTGAAAAGGGGATGTGGTTGCCTGCCTGTGGGA	13	12	18	16	5	er	cooperative
seq603_all_clean_seqs_gap0_no20_0.4	AGTAGGTCTCTCAGAGGAAACCACAGTAGCAGCCTC	16	15	21	19	5	er	independent
seq604_all_clean_seqs_gap0_no20_0.4	GATACTCTTCCTGTCATCCCATCCCCACAGCCTTAG	9	7	25	23	16	er	independent
seq605_all_clean_seqs_gap0_no20_0.4	GCAAGGCAACAGGAAATTGTGGGGAAATTTTAAAAA	12	11	20	18	8	er	independent
seq606_all_clean_seqs_gap0_no20_0.4	CCATGCGCTGCTTCCTTCCACTTACCGCCCTCGCAC	13	11	25	23	12	er	independent
seq608_all_clean_seqs_gap0_no20_0.4	GGGCTCGGGGAGGAAGCGGTGGTTTCTCTTTGAAGC	12	11	20	18	8	er	independent
seq610_all_clean_seqs_gap0_no20_0.4	ACAGGAAACTAAAATAAGAACAGAAAACCAAGACAG	4	3	28	26	24	er	independent
seq611_all_clean_seqs_gap0_no20_0.4	AGAGGCAGCTTCCGGAGACTGCTCTGTGGCCAGTTT	11	9	27	25	16	er	independent
seq614_all_clean_seqs_gap0_no20_0.4	ACAGTTTCCTTGCTGTGATGTCAGCCCCCGCCGCAG	7	5	31	29	24	er	independent
seq617_all_clean_seqs_gap0_no20_0.4	GTGAATGAGGGGGAAGGAAGTGGTTTGGAAAAATAC	16	15	21	19	5	er	ambiguous
seq619_all_clean_seqs_gap0_no20_0.4	ACCGGATGCCGGGGCACCGCCAGATGTGGCCACGAG	4	3	27	25	23	er	independent
seq620_all_clean_seqs_gap0_no20_0.4	AGCGCGCCGCCGACCGGATGCGGGAACTGGGCTCGG	16	15	21	19	5	er	cooperative
seq621_all_clean_seqs_gap0_no20_0.4	TGTTTACTTCCTGGAGGCACTTTGGTTTTTCTTTCT	9	7	23	21	14	er	ambiguous
seq623_all_clean_seqs_gap0_no20_0.4	AGGAGAACTTCCGCCCTTACTATATTACCGCCGGTA	10	8	28	26	18	er	independent
seq624_all_clean_seqs_gap0_no20_0.4	TGTCGGGCGGATGTGTACCGGCGGTAATATAGTAAG	9	8	22	20	13	er	independent
seq625_all_clean_seqs_gap0_no20_0.4	CAGTGGCTTCCTCCCCACCTCCTACCACATTCAATG	9	7	25	23	16	er	ambiguous
seq626_all_clean_seqs_gap0_no20_0.4	TTCAGAAAAAAAGGAAGTGGTAAATTCTTGCTGATT	13	12	18	16	5	er	cooperative
seq628_all_clean_seqs_gap0_no20_0.4	CTGCGTCCCGGAAGGAGCGAGCTTGCGGAGCGTGAA	10	9	26	24	16	er	independent
seq631_all_clean_seqs_gap0_no20_0.4	GAAGGCGGTTCCGGTTCGCGGCGGTTCCCGGGTTTT	10	8	22	20	12	er	independent
seq632_all_clean_seqs_gap0_no20_0.4	GAGGCGACCCACATCCGCTGTGCGGGGGCAACTGCA	14	12	23	21	9	er	ambiguous
seq637_all_clean_seqs_gap0_no20_0.4	CTGAGCCGGGACCGGAAGCCGCACCGCCCCCCGCGC	14	13	19	17	5	er	independent
seq638_all_clean_seqs_gap0_no20_0.4	GCGGGGACCCGGATGTGTGTGGTGGCGGCGGCCGAA	11	10	20	18	9	er	ambiguous
seq639_all_clean_seqs_gap0_no20_0.4	GGAGCAACCGGCCGGATACCGCCACAGCCCTGGCAG	14	13	19	17	5	er	independent
seq63_all_clean_seqs_gap0_no20_0.4	CCTTCCTTCCGGGGTCGGCCCCGCCCGCAAGCGCCG	8	6	25	23	17	er	independent
seq640_all_clean_seqs_gap0_no20_0.4	CACCTGCCTTGCTTCCTGCGGTGCAACCAGCGGGAG	14	12	19	17	5	er	independent
seq644_all_clean_seqs_gap0_no20_0.4	AACAGCTTTTGTCCAGGATGTGGCTTCATAGCCTTG	16	15	21	19	5	er	independent
seq645_all_clean_seqs_gap0_no20_0.4	CATTTCTTCCTTCCTTGGCCCCCGCAGTGCGCCCGC	12	10	22	20	10	er	independent
seq646_all_clean_seqs_gap0_no20_0.4	TGCACCCGCCACTTCCGCATCGAACCGCCGCTTCAA	14	12	25	23	11	er	independent
seq647_all_clean_seqs_gap0_no20_0.4	TGCGCATCGTGCTCATCCGCAGCCGCAAAGTGGGGC	16	14	23	21	7	er	independent
seq64_all_clean_seqs_gap0_no20_0.4	CTCTGCAGACAGGAAAGCTAGGTGTGGGTGTACTGT	12	11	25	23	13	er	independent
seq650_all_clean_seqs_gap0_no20_0.4	GGGCGCGACTTCCGGGGCGGCGGTTGCATCAGATTC	11	9	21	19	10	er	independent
seq652_all_clean_seqs_gap0_no20_0.4	TGGTTAGGGAGAGGGGGATGTGGTTAGGGTGAGGGA	16	15	21	19	5	er	cooperative
seq653_all_clean_seqs_gap0_no20_0.4	TGAGCTCAGGCCGGAAGCGGTGGATGATGGCACACA	13	12	18	16	5	er	independent
seq654_all_clean_seqs_gap0_no20_0.4	GTAGAGACAGGAAATTATGTTGGTTTTCTTGCAGAA	10	9	21	19	11	er	independent
seq655_all_clean_seqs_gap0_no20_0.4	TGCTTAGAACACGGAAACACTGAGGTTTTACTTTGA	13	12	23	21	10	er	independent
seq657_all_clean_seqs_gap0_no20_0.4	CACCTGCAGTGAAGAGGATGTGGGCAAAGATTATGC	16	15	21	19	5	er	cooperative
seq658_all_clean_seqs_gap0_no20_0.4	CCCAACCATTTCCGCCACACCTCCAACCCACTGCCG	11	9	28	26	17	er	independent
seq659_all_clean_seqs_gap0_no20_0.4	ATGTTTGGGGCCGGAAGTGGGTTGGAGGTGTGGCGG	13	12	18	16	5	er	independent
seq65_all_clean_seqs_gap0_no20_0.4	AAAGGGCAGACTTCCCTGCCCACATCTCTGCTCCTG	13	11	20	18	7	er	independent
seq660_all_clean_seqs_gap0_no20_0.4	GGCCGCCGCTTCCCGTCCAGGGCCGCAGTCTGCCCG	11	9	23	21	12	er	independent
seq661_all_clean_seqs_gap0_no20_0.4	GGTGTGTTCTGGGGAGGAAGTGGGTTTTCAGGTTGT	16	15	21	19	5	er	cooperative
seq662_all_clean_seqs_gap0_no20_0.4	GTTGGGGTGCGTGTAGGATGTGGTCTGGGATGATTA	16	15	21	19	5	er	cooperative
seq664_all_clean_seqs_gap0_no20_0.4	TAGCAGGAAGCCGATTCGCCCTATATGCAACCACTT	6	5	31	29	25	er	ambiguous
seq665_all_clean_seqs_gap0_no20_0.4	CGAAGGAGGAAGCTGCACAGGGTGTCTGTGGCTGGC	8	7	29	27	21	er	independent
seq666_all_clean_seqs_gap0_no20_0.4	GACTCCATTTCCCGTCGGCTCGCGGTGGGAGCGCCG	10	8	23	21	13	er	independent
seq667_all_clean_seqs_gap0_no20_0.4	GCCTGCACCCTAGTTCCGGTGTGGGTGGAGGGGCCG	15	13	22	20	7	er	independent
seq669_all_clean_seqs_gap0_no20_0.4	CGGGAACACCCACTTCCGCCACAGACCTGCTCAAAA	15	13	19	17	4	er	independent
seq66_all_clean_seqs_gap0_no20_0.4	GCATTGTGCTTCCGCTCGGGGAAAGACCGCTTACGG	11	9	27	25	16	er	independent
seq671_all_clean_seqs_gap0_no20_0.4	ACACCTCAGGCAGGATGTGGTAGGGGTTGCCCCAGA	13	12	18	16	5	er	cooperative
seq673_all_clean_seqs_gap0_no20_0.4	TTACTTCTCAGGAAGCGCTGTGGGGCTGGGGTTGCT	11	10	21	19	10	er	independent
seq674_all_clean_seqs_gap0_no20_0.4	ATGCCAAGGGACTTCCCTCCACAACCGCCCCCAGCT	14	12	25	23	11	er	independent
seq675_all_clean_seqs_gap0_no20_0.4	TGGGGAGCAGGAAGCTGGGGGCGGTTGTGGAGGGAC	10	9	22	20	12	er	independent
seq676_all_clean_seqs_gap0_no20_0.4	CAGCAAGCGTCCAGGAAGTGTGTGGGGGAGGTGTGG	14	13	23	21	9	er	independent
seq67_all_clean_seqs_gap0_no20_0.4	GACGGGAGCACCGGAAGCGGTCTTTCCCCGAGCGGA	13	12	18	16	5	er	independent
seq680_all_clean_seqs_gap0_no20_0.4	CTAGCAGGAAACAGACAGACCCAGCCACAGAATCTC	7	6	25	23	18	er	independent
seq681_all_clean_seqs_gap0_no20_0.4	ATGACTTAGCAACATCCTGACAACCACTACATTGTC	15	13	24	22	9	er	independent
seq682_all_clean_seqs_gap0_no20_0.4	ACCTCAAGCCCAGGATGTGGTTTGGCCACTATTGAG	13	12	18	16	5	er	cooperative
seq683_all_clean_seqs_gap0_no20_0.4	AACTTAGCTTCCGGGAAGAAGGCGAGCGGTGGGAGG	10	8	27	25	17	er	independent
seq684_all_clean_seqs_gap0_no20_0.4	GAATCACCATTTCCTCACTCCCACACAACCATGTTG	12	10	21	19	9	er	independent
seq685_all_clean_seqs_gap0_no20_0.4	TGGTTAAGCAGTGCAGGATGTGGGCTGCACTGCTAA	16	15	21	19	5	er	cooperative
seq686_all_clean_seqs_gap0_no20_0.4	TCAGGGGAGCGAGCAGGAAGTGGTAAGATTTGATAG	16	15	21	19	5	er	cooperative
seq688_all_clean_seqs_gap0_no20_0.4	CAGAGAGCGGACTTCCGCGACGCGGGTAAGCCGGGC	14	12	23	21	9	er	independent
seq689_all_clean_seqs_gap0_no20_0.4	CCGCTTCCGGCCTTCGCCCGGCTTACCCGCGTCGCA	6	4	27	25	21	er	independent
seq68_all_clean_seqs_gap0_no20_0.4	GGAGCGACGGAAGCACCTGAAGCGGTCTTTCCCCGA	9	8	23	21	14	er	ambiguous
seq690_all_clean_seqs_gap0_no20_0.4	CTGAGCAAAAGGAGGAAGCTGTGGTCTGTGTACCCA	14	13	22	20	8	er	cooperative
seq691_all_clean_seqs_gap0_no20_0.4	TGCATGTGCAGCAGAGGAAACCACAAGTTATTCCCT	16	15	21	19	5	er	cooperative
seq692_all_clean_seqs_gap0_no20_0.4	TACATCTTCAGAGGAAGTGGGTTTGTGTATCTTTGA	13	12	18	16	5	er	cooperative
seq693_all_clean_seqs_gap0_no20_0.4	CTCTTGGCGGACGTTCCACATTACCACTGACTTTGT	9	8	24	22	15	er	independent
seq697_all_clean_seqs_gap0_no20_0.4	ATGGTGTAGAGAGGATGTGGGCTTTAAGGTCAGAGA	13	12	18	16	5	er	independent
seq698_all_clean_seqs_gap0_no20_0.4	TACAGCTGGAACGTCCTGTGGTTAACATTCTGCTCT	14	12	19	17	5	er	independent
seq699_all_clean_seqs_gap0_no20_0.4	CAAAGGGGAACGAGGAAACCGCCAGGGGCGGGGCGG	14	13	19	17	5	er	independent
seq700_all_clean_seqs_gap0_no20_0.4	GCCACACCCCCTTCCTGTTGTGTGTGGGGATTCATG	13	11	25	23	12	er	independent
seq701_all_clean_seqs_gap0_no20_0.4	CCTCATTTCCGGGCTGTTTGCGCGCAAGCCCACATC	8	6	30	28	22	er	independent
seq702_all_clean_seqs_gap0_no20_0.4	CTGCAGACAGGAGGATGTGGGCTTGCGCGCAAACAG	13	12	18	16	5	er	independent
seq703_all_clean_seqs_gap0_no20_0.4	AGCCCCTACCACTTCCCCCCACAGCAGTTCTGAGAT	14	12	19	17	5	er	ambiguous
seq706_all_clean_seqs_gap0_no20_0.4	TGGCTTGTTTCCGGTTCCTCTGTGGCGCCGTTCTCG	10	8	23	21	13	er	independent
seq707_all_clean_seqs_gap0_no20_0.4	ACAAGCCATTTCCCATTCTTGTGGCTGTAGAGGGGA	11	9	22	20	11	er	independent
seq708_all_clean_seqs_gap0_no20_0.4	GCACCAGAGGAAGCTGAGGAGGAGGTGCGGTGGCTG	9	8	28	26	19	er	independent
seq709_all_clean_seqs_gap0_no20_0.4	ACCTTCTGTTCCCTTCCTCAGACCGCAGGCGAGATG	15	13	23	21	8	er	cooperative
seq70_all_clean_seqs_gap0_no20_0.4	AATGGCGGGAAGTAAGAGGAATGTGGGCCTGACTGC	8	7	24	22	16	er	ambiguous
seq710_all_clean_seqs_gap0_no20_0.4	GACCTGGGCAGGAAGAGCGGCATGTGGGGCCCCCTG	11	10	25	23	14	er	independent
seq711_all_clean_seqs_gap0_no20_0.4	CAAAGTGATGGGGGAAATGGTTGTGGTTTTGGGTGG	13	12	24	22	11	er	cooperative
seq712_all_clean_seqs_gap0_no20_0.4	GGGGTGCTGGGAAATGGAGCGAGAGGTGGTTTCCAG	10	9	27	25	17	er	independent
seq713_all_clean_seqs_gap0_no20_0.4	AAACCCCAAACAGGAAGTGGTAAAGCAACCTGCATC	13	12	18	16	5	er	ambiguous
seq714_all_clean_seqs_gap0_no20_0.4	GGCAGGCAGCAGAGGAAACCACCCCCACCCACTCCC	14	13	19	17	5	er	independent
seq715_all_clean_seqs_gap0_no20_0.4	GGCCCGGCCGGAAGAAGCCACCTCCCCCGCACGCGT	10	9	27	25	17	er	independent
seq716_all_clean_seqs_gap0_no20_0.4	GAACCCAGGTCTGCTTCCTGTGGCCACCATCTGTGC	16	14	21	19	5	er	independent
seq717_all_clean_seqs_gap0_no20_0.4	TTAAGGAGCTTCCGGGGCCGCGGGTAGAGGCGGGTG	11	9	21	19	10	er	independent
seq718_all_clean_seqs_gap0_no20_0.4	AGGCAAACAGGATGTTCCTCTCCCACATGCAGACTT	10	9	23	21	13	er	independent
seq719_all_clean_seqs_gap0_no20_0.4	TACTTCTTCCTGGCAGAGACCGGGAGTGCGGTCCGC	8	6	29	27	21	er	independent
seq720_all_clean_seqs_gap0_no20_0.4	GTGCCGGCGGCCGGATGTGGGCGGGGCCACGGGGAG	13	12	18	16	5	er	cooperative
seq721_all_clean_seqs_gap0_no20_0.4	GTTCTCAGCTTCCTGTTCACAGAGAAACCTCAGACA	11	9	28	26	17	er	independent
seq723_all_clean_seqs_gap0_no20_0.4	AGCTAAACCCAGTTCCGGTGCTGTGGGGAGCTCAGA	14	12	24	22	10	er	independent
seq724_all_clean_seqs_gap0_no20_0.4	CGGCATCTGACAGGATGTGGGCAGGGAGAGAGAGAC	13	12	18	16	5	er	cooperative
seq726_all_clean_seqs_gap0_no20_0.4	GGATTAGAACTGCTTCCTCCTGTGGTTTACCAGAAA	15	13	23	21	8	er	cooperative
seq727_all_clean_seqs_gap0_no20_0.4	AGGCTTCCTGTTTTATCTCGTGTGTGTGGTGCACCA	6	4	27	25	21	er	independent
seq728_all_clean_seqs_gap0_no20_0.4	CGTTTCCTGTGGCTGCAGCTCTCCCCACCCACACAC	5	3	29	27	24	er	independent
seq729_all_clean_seqs_gap0_no20_0.4	CGGCACCCTCCTTCCTCCCTGCCAACCGCCTCCACC	13	11	26	24	13	er	ambiguous
seq730_all_clean_seqs_gap0_no20_0.4	GATTCATATCCTCCTCTATGCAACCACAGCATCTTC	9	7	24	22	15	er	independent
seq731_all_clean_seqs_gap0_no20_0.4	GGGCGGGTCAGCGGAAGTGAGGGCGGTTGAGGCTGG	13	12	24	22	11	er	independent
seq733_all_clean_seqs_gap0_no20_0.4	AACCAATCGAGCGGAGGAAACCGCGGCGTTAGCGTG	16	15	21	19	5	er	independent
seq736_all_clean_seqs_gap0_no20_0.4	AGGGAGCCCTCCATTTCCTGCCCACATTTGTCACCT	16	14	22	20	6	er	independent
seq738_all_clean_seqs_gap0_no20_0.4	CTGGGGCTGAGGGAGGGATGTGGTGGGGCCCAGGCT	16	15	21	19	5	er	independent
seq73_all_clean_seqs_gap0_no20_0.4	CTGGGCAGGAAAGGACCTGGCCTCCCAGCCCACAGG	8	7	30	28	22	er	independent
seq740_all_clean_seqs_gap0_no20_0.4	CCGCGCACCCGGAACTACCTCCCGACCCGCATCCCC	11	10	27	25	16	er	independent
seq741_all_clean_seqs_gap0_no20_0.4	GCACCCGGCACTACTTCCCGACCCGCATCCCCCGCC	16	14	23	21	7	er	independent
seq742_all_clean_seqs_gap0_no20_0.4	AACGACAAACCGGAAGTATGGTTTGCCGCCTGAAGC	12	11	19	17	7	er	independent
seq743_all_clean_seqs_gap0_no20_0.4	AGCGGCTCCTTCCGGCGGCGCGGGTTCCCTTCCCTC	11	9	21	19	10	er	independent
seq744_all_clean_seqs_gap0_no20_0.4	TAGGTTAGAATAAGAGGAAACCTCAAACCAGAACCC	16	15	21	19	5	er	ambiguous
seq746_all_clean_seqs_gap0_no20_0.4	GCGCCCCGTCCTTCCGCAGCCCAACCGCCTCTTCCC	13	11	25	23	12	er	independent
seq748_all_clean_seqs_gap0_no20_0.4	GCTATCGAGCTTCCTGCAGCGGTGGCCACCCGAGCA	12	10	20	18	8	er	independent
seq749_all_clean_seqs_gap0_no20_0.4	TCCCCGGCAGCTTCCTCGCCCCGACCGCAGTGTTCC	13	11	25	23	12	er	cooperative
seq74_all_clean_seqs_gap0_no20_0.4	TTACCATCGCCCTTCCTGTGGGCTGGGAGGCCAGGT	14	12	19	17	5	er	ambiguous
seq750_all_clean_seqs_gap0_no20_0.4	TCAAGAGGGTGTGGAGGAAGTGGGTTACAAGCACTT	16	15	21	19	5	er	independent
seq753_all_clean_seqs_gap0_no20_0.4	AGAACAGCAGGAAATAAATACCCACCTCAGGACTGC	10	9	22	20	12	er	independent
seq755_all_clean_seqs_gap0_no20_0.4	CCAGCCTCCCCTTTCCTGTCTGTGGCAGGAGCGTGC	14	12	23	21	9	er	independent
seq756_all_clean_seqs_gap0_no20_0.4	GGGGCAGGAAACAGCGTCCTGCGCGGGTAGCCCCTG	7	6	24	22	17	er	independent
seq758_all_clean_seqs_gap0_no20_0.4	GGGGGCAGGAAGCAGTGCAGCTCCTTAACCCACTTC	8	7	30	28	22	er	independent
seq759_all_clean_seqs_gap0_no20_0.4	GATGCTCTAACAGGAAGTGGGTTAAGGAGCTGCACT	13	12	18	16	5	er	ambiguous
seq763_all_clean_seqs_gap0_no20_0.4	TATATGCACAGGAAGTCCCTTACAACCCACTCTGTT	11	10	27	25	16	er	independent
seq764_all_clean_seqs_gap0_no20_0.4	GCCAAGGCCTTCCGCCGAGTTGGTTTTTGGGTTGTT	11	9	21	19	10	er	ambiguous
seq765_all_clean_seqs_gap0_no20_0.4	GAATGACAGGAAGATGATTAGTGATAGTGGGTTTGG	9	8	28	26	19	er	independent
seq766_all_clean_seqs_gap0_no20_0.4	TTTCTTCCTGTTTGCATCACCCCAAACCCACTATCA	6	4	28	26	22	er	independent
seq767_all_clean_seqs_gap0_no20_0.4	CGTTATTTCCGGGGCTGGGTTAACGCAGCGGTTCCA	8	6	29	27	21	er	independent
seq768_all_clean_seqs_gap0_no20_0.4	GCAAAGATACATCCTTCTCCCCACAGACTAAGTTTC	12	10	21	19	9	er	independent
seq770_all_clean_seqs_gap0_no20_0.4	TTAGGCAGAGCTCATTTCCGCCCACATCAAAAGTAA	17	15	22	20	5	er	independent
seq771_all_clean_seqs_gap0_no20_0.4	CACCCGCCCCCCGGAAGTGCCGGTGGTTGGGCTCCG	13	12	24	22	11	er	independent
seq772_all_clean_seqs_gap0_no20_0.4	CCGCCCACTTCCGTGTGGCCGCCGATTGGTTTTGCC	10	8	27	25	17	er	independent
seq773_all_clean_seqs_gap0_no20_0.4	AGACCCGGAAATGGTGGGTGTTTCTTGCAACCACGG	7	6	31	29	24	er	independent
seq774_all_clean_seqs_gap0_no20_0.4	GAGTCGCTTCCGCTCCCGCCCCGCTCTGTGGCGTAG	9	7	29	27	20	er	independent
seq775_all_clean_seqs_gap0_no20_0.4	TGGGCACGGGAGGAAGAGGCTGGGTGGTAAACAGGA	12	11	25	23	13	er	independent
seq776_all_clean_seqs_gap0_no20_0.4	GAGCGCCCACTTCCTGTTTACCACCCAGCCTCTTCG	12	10	21	19	9	er	independent
seq777_all_clean_seqs_gap0_no20_0.4	GACAGGAAGTGACCTCAATTTCCCCGGCCACAGAAA	5	4	28	26	23	er	ambiguous
seq778_all_clean_seqs_gap0_no20_0.4	ACCGGGTGCTGAGGAGGAAGTGGTTGCTATAACCCC	16	15	21	19	5	er	ambiguous
seq779_all_clean_seqs_gap0_no20_0.4	GCGTTTCCCCCTTGGGGTTATAGCAACCACCTCCTC	6	4	27	25	21	er	independent
seq780_all_clean_seqs_gap0_no20_0.4	TTAGGCTCATGGGAAATGTGGTTTCTAAATCGCGGG	12	11	19	17	7	er	independent
seq781_all_clean_seqs_gap0_no20_0.4	GGCGGCTTCCGGGATCTGCCTGGCGGTTGCTTTGTC	8	6	24	22	16	er	ambiguous
seq782_all_clean_seqs_gap0_no20_0.4	AACCCGGAAGTGGACACGGAGCTCGGCTGCGGCTCC	6	5	30	28	24	er	independent
seq783_all_clean_seqs_gap0_no20_0.4	AGGGAGGAAGGGTACTGTTGGGAGCCCGCAATGGAA	6	5	26	24	20	er	independent
seq785_all_clean_seqs_gap0_no20_0.4	CATAGGAAGTGCTCAGCTCTCCTCCACCGCAAGTTT	5	4	27	25	22	er	cooperative
seq786_all_clean_seqs_gap0_no20_0.4	CTGCCGGAAGCTGCCCCTCCACCATTTTGTGGCCCG	6	5	30	28	24	er	independent
seq789_all_clean_seqs_gap0_no20_0.4	AGCGGGAGGAAGTGCTGCAGTAGCCACAGCAGCCTG	8	7	24	22	16	er	independent
seq78_all_clean_seqs_gap0_no20_0.4	CTGCTTCCGGCCCCGGGGTTCGCTACCCCACAATCC	6	4	28	26	22	er	independent
seq792_all_clean_seqs_gap0_no20_0.4	ACCCACCCGGAAGTCCTCCTGGCCCACAAGCTCCGC	9	8	24	22	15	er	independent
seq793_all_clean_seqs_gap0_no20_0.4	GAGGACTTCCGGGTGCGTGTGATATCTGCGGGCCCG	8	6	29	27	21	er	independent
seq794_all_clean_seqs_gap0_no20_0.4	AGCTGCTGTTTTCCGGCTGCGGCACTGGATGAAGGA	12	10	20	18	8	er	ambiguous
seq797_all_clean_seqs_gap0_no20_0.4	CCGCCACCGGAAGCGCCCTCCTAATCCCCGCAGCGC	9	8	28	26	19	er	independent
seq798_all_clean_seqs_gap0_no20_0.4	GAGATACACAGCGACATCCGCCCGCAAGAGCATGGT	17	15	22	20	5	er	ambiguous
seq79_all_clean_seqs_gap0_no20_0.4	GATCTTCCTGCAACCCCCCGAGACAACCACCGAACA	6	4	27	25	21	er	independent
seq800_all_clean_seqs_gap0_no20_0.4	GAGCCGGAAGTGAAGGAGGGCTTGTGGGAGATGGAG	6	5	25	23	19	er	independent
seq801_all_clean_seqs_gap0_no20_0.4	TAGAAAAGGAAGCAGGGTAGGTGTGGTATCTGGGTC	8	7	24	22	16	er	independent
seq803_all_clean_seqs_gap0_no20_0.4	TGCGCCGCGGAACCCGGAAGTGGTCACGGAGCTCGG	16	15	21	19	5	er	cooperative
seq804_all_clean_seqs_gap0_no20_0.4	TGTTAGAGCAGCTGCTTCCTCCCGCAACACACGGCC	17	15	22	20	5	er	independent
seq805_all_clean_seqs_gap0_no20_0.4	ATACATACAGGATGACATTTGTCCTGTGGGCACCAG	10	9	27	25	17	er	independent
seq806_all_clean_seqs_gap0_no20_0.4	GGTCAGGTGGGCGTTTCCTGTGGGCGTCTCCAACTC	16	14	21	19	5	er	independent
seq807_all_clean_seqs_gap0_no20_0.4	CCAACAGTACCCTTCCTCCCTTAACCACAAGACTGA	14	12	25	23	11	er	cooperative
seq808_all_clean_seqs_gap0_no20_0.4	ATGTTAACATCCTGCCATGAAAACCGCAAGAAGGGC	10	8	24	22	14	er	cooperative
seq809_all_clean_seqs_gap0_no20_0.4	GTCCTCTTCCTGTCCCCCAGGTGGGCATGTGGTTTG	8	6	30	28	22	er	cooperative
seq80_all_clean_seqs_gap0_no20_0.4	CCTGAGAGATCCGGCGCGCGTCTTCCACCACAATGC	10	8	28	26	18	er	independent
seq810_all_clean_seqs_gap0_no20_0.4	TCTTTGAGAAGCGGATGTGGTAAACTTGCCTCTGTT	13	12	18	16	5	er	cooperative
seq812_all_clean_seqs_gap0_no20_0.4	TGTCCGGGCAGGAAGGGGTGCTCTGTGGGCTTGGAG	11	10	26	24	15	er	independent
seq813_all_clean_seqs_gap0_no20_0.4	CCAGGAAGGCGCCTGCATCCTCCAAGCCCACAGAGC	4	3	28	26	24	er	ambiguous
seq814_all_clean_seqs_gap0_no20_0.4	TAAGGATGTGTGGCTTCCAGATCAAAAACCGCAAAA	4	3	29	27	25	er	cooperative
seq817_all_clean_seqs_gap0_no20_0.4	TGCTGTTTCCTCTGCTGCCGAAGCGGTTTCTTCCAC	8	6	24	22	16	er	independent
seq81_all_clean_seqs_gap0_no20_0.4	CTGTCTGCTTCCCGTGGCCAGCCCTGACCGCGGCCC	10	8	28	26	18	er	cooperative
seq820_all_clean_seqs_gap0_no20_0.4	GTCGTGTTTGGCTTCCTGTGGGCACGCCTGCGTAGC	14	12	19	17	5	er	independent
seq821_all_clean_seqs_gap0_no20_0.4	GCCAGGAAGCCAAGGTCGCGCCCTCCACCGCAGGTC	5	4	28	26	23	er	independent
seq822_all_clean_seqs_gap0_no20_0.4	GTGAGAGGAAGTGGGCGCTGGTTTAATGTGGTCAGC	7	6	29	27	22	er	cooperative
seq823_all_clean_seqs_gap0_no20_0.4	CTGAGGAAATTGGCTCCACGATAAAGTGGTTTGGCC	5	4	27	25	22	er	independent
seq824_all_clean_seqs_gap0_no20_0.4	GTCCCACGCGACTTCCTGCGGGAAACATGGCGGCAT	14	12	19	17	5	er	independent
seq825_all_clean_seqs_gap0_no20_0.4	CGTCACTTCCCACGCGACTGCCTGCGGGAAACATGG	8	6	25	23	17	er	cooperative
seq826_all_clean_seqs_gap0_no20_0.4	TGGGGCCCGGAAGCGCTGGCGCCTTGCGGCCAGAAG	9	8	27	25	18	er	cooperative
seq827_all_clean_seqs_gap0_no20_0.4	ACGTCAGCATCCGCCGGGCTCGCGGTAAGGTGTGAG	10	8	23	21	13	er	independent
seq829_all_clean_seqs_gap0_no20_0.4	GCAAACGGAAGAGAGGAACGAAGGCCGCAGAGCTTG	7	6	25	23	18	er	independent
seq82_all_clean_seqs_gap0_no20_0.4	TTACACCCAAGGGATGTTGTTTGTGGGGGGCGGGGT	12	11	24	22	12	er	independent
seq830_all_clean_seqs_gap0_no20_0.4	GCCCGGAAGCGCGACGCTGGAGCTGCGGGGTTACCA	5	4	26	24	21	er	independent
seq831_all_clean_seqs_gap0_no20_0.4	ACGTCTTTATTTATCCTGTGGCTTCCCGACCCCCAC	14	12	19	17	5	er	independent
seq832_all_clean_seqs_gap0_no20_0.4	CAGTGCCAGCCGGAACTTGTGGTTCGGACCGTGGGT	12	11	20	18	8	er	cooperative
seq833_all_clean_seqs_gap0_no20_0.4	TCCCCACATCCTTTAAAACGATGAGATAACCACATG	9	7	30	28	21	er	cooperative
seq834_all_clean_seqs_gap0_no20_0.4	TGAGCCTTGGAAGGAAATGATTCACCACAATACTGT	13	12	25	23	12	er	cooperative
seq835_all_clean_seqs_gap0_no20_0.4	CAAGAGGAACCGGAACTTTGGAAACCACATTCTTAT	12	11	25	23	13	er	cooperative
seq837_all_clean_seqs_gap0_no20_0.4	AGAGCGAGGAGGACTTCCTGCGGCAGGTCGGCGTGA	16	14	21	19	5	er	independent
seq83_all_clean_seqs_gap0_no20_0.4	GCGCGGGCAACTTCCGGTGTGGGTGACGAGTGGTGG	13	11	20	18	7	er	independent
seq841_all_clean_seqs_gap0_no20_0.4	GCAACGGAGTCCGGAAGAACCACAGAGACGCGGCTC	13	12	20	18	7	er	independent
seq842_all_clean_seqs_gap0_no20_0.4	GGCTTCCGCCGCCACCACTGCCCCTCAACCGCCACG	5	3	29	27	24	er	independent
seq843_all_clean_seqs_gap0_no20_0.4	GCTGTCCGTTTCCGAGATGTTAATGCGGGGTCTTGC	11	9	26	24	15	er	independent
seq844_all_clean_seqs_gap0_no20_0.4	GCTGTCCGTTTCCGAGATGTTAATGCGGGATCTTGC	11	9	26	24	15	er	independent
seq846_all_clean_seqs_gap0_no20_0.4	GCTGTCCATTTCCGAGATGTTAATGCGGGATCTTGC	11	9	26	24	15	er	independent
seq847_all_clean_seqs_gap0_no20_0.4	ACAGTCGCACCGGAAGCTGCCCGCGGTGTTGACACA	12	11	24	22	12	er	independent
seq84_all_clean_seqs_gap0_no20_0.4	ATCATCCTGACCATATGTTTCTTTAGGCCACAAAAC	5	3	28	26	23	er	independent
seq850_all_clean_seqs_gap0_no20_0.4	GAAATTTCCGCTTTCTTTCTGCAGCAGGAACCGCGG	7	5	31	29	24	er	independent
seq851_all_clean_seqs_gap0_no20_0.4	GCACCATCTCCCGACTTCCGCGGTGTCCCAGGTCCT	17	15	21	19	4	er	independent
seq852_all_clean_seqs_gap0_no20_0.4	CCATTCACGGGCTTCCGCGGTGTCCCCACCCCCTAA	14	12	18	16	4	er	independent
seq853_all_clean_seqs_gap0_no20_0.4	GCCTCCTCCCATTTCCTCCATGTGGTCAATCCAGTT	14	12	23	21	9	er	cooperative
seq854_all_clean_seqs_gap0_no20_0.4	GCGCGGCTCAGGAAGCGACGCGGTTCAGGGAGCGAA	11	10	21	19	10	er	independent
seq855_all_clean_seqs_gap0_no20_0.4	TGCTCCACTCGGAAGTGGTGCCGCAGCTCTTCGATG	11	10	21	19	10	er	independent
seq856_all_clean_seqs_gap0_no20_0.4	ACAGGAAGAGATATTATATCTCCCTGCGGTTGGTTT	4	3	27	25	23	er	cooperative
seq857_all_clean_seqs_gap0_no20_0.4	CGGCTGGCAGGAAGTGGCCACTTGAACCGCAGATGC	10	9	27	25	17	er	cooperative
seq858_all_clean_seqs_gap0_no20_0.4	ACCAGCCCAGGAAGCATCTGCGGTTCAAGTGGCCAC	10	9	21	19	11	er	cooperative
seq861_all_clean_seqs_gap0_no20_0.4	TGCCGGGCCCCGGATGTCACCGCAGCCGCCATCTTA	12	11	20	18	8	er	cooperative
seq862_all_clean_seqs_gap0_no20_0.4	TGGGCCAGCACGTCCGGGTGGTCAGGACGCGCGCTT	13	11	19	17	6	er	independent
seq864_all_clean_seqs_gap0_no20_0.4	GAAGCGCTGGGCGGAAGTGGCTGTGGCTTTGCCCTT	13	12	24	22	11	er	cooperative
seq866_all_clean_seqs_gap0_no20_0.4	CAGAGGAGGAAGAGGAAGCCACAGCGATAGGGTCAC	14	13	19	17	5	er	independent
seq869_all_clean_seqs_gap0_no20_0.4	GCCGCCGTTTCCTGATTGGTTGTGGGTGGCTACCTC	10	8	23	21	13	er	independent
seq870_all_clean_seqs_gap0_no20_0.4	TGTTGGCTGTCCTCCGGAAACCCGCGCCTGGGTCGC	16	15	22	20	6	er	independent
seq871_all_clean_seqs_gap0_no20_0.4	AACAGATCCTTCCTGGCCCCCACTAGCCACAGGTTT	11	9	27	25	16	er	independent
seq873_all_clean_seqs_gap0_no20_0.4	CCCCGGGAAGGGAAGTTTGTGGCGGAGGAGGTTCGT	11	10	20	18	9	er	independent
seq874_all_clean_seqs_gap0_no20_0.4	CCTGCCTGACCGGAAGTGCCCGCAACCCCACCGACC	12	11	20	18	8	er	independent
seq878_all_clean_seqs_gap0_no20_0.4	TTCAGTCCTGGTTTCCTGTGGTTCTAGGATCTTTAT	14	12	19	17	5	er	independent
seq879_all_clean_seqs_gap0_no20_0.4	TGTGATAAGGATGTTCGTGTGCCTTGTGGTCAGGTG	9	8	27	25	18	er	cooperative
seq880_all_clean_seqs_gap0_no20_0.4	AGAAACATCCTGCCCAGCCACCTGACCACAAGGCAC	8	6	26	24	18	er	cooperative
seq881_all_clean_seqs_gap0_no20_0.4	ACGGACAGAATTTCCTCCCCCGTCACCACAGCGACC	13	11	26	24	13	er	independent
seq882_all_clean_seqs_gap0_no20_0.4	TGTTTTCGCTCTTCCTGGCCTTGCGGGCAGCCAGGA	13	11	24	22	11	er	cooperative
seq883_all_clean_seqs_gap0_no20_0.4	CTCCCACGCTCCCCTTCCGGCCCCGCAGCGCTGTGA	16	14	23	21	7	er	independent
seq884_all_clean_seqs_gap0_no20_0.4	CCGCGCCGCTTCCTCCAGACACCGCAAGGGGGTGCT	11	9	22	20	11	er	cooperative
seq885_all_clean_seqs_gap0_no20_0.4	GGGTGCTTCCTATAAACAATGACTCATTACCGCACT	8	6	30	28	22	er	independent
seq886_all_clean_seqs_gap0_no20_0.4	TCTTTTTATTTCCTGTGCAGTCTCGCCCACAGCACT	11	9	27	25	16	er	independent
seq887_all_clean_seqs_gap0_no20_0.4	CAGCCCTAGCGAGTTTCCTGCGGGGAAGGGCATTCC	16	14	21	19	5	er	independent
seq889_all_clean_seqs_gap0_no20_0.4	CCATATCTGGCTTCCTAAGGAGGAACCACAAACCGT	13	11	26	24	13	er	ambiguous
seq890_all_clean_seqs_gap0_no20_0.4	CGGGCCCGACGGAAACCATGTTTGTGGCTCGCAGCA	11	10	25	23	14	er	independent
seq892_all_clean_seqs_gap0_no20_0.4	TCTCTACTTCCCATTATTTCTGTGGTTAATTTCACC	9	7	23	21	14	er	cooperative
seq896_all_clean_seqs_gap0_no20_0.4	TGCCGGAAGCCCGCCAGGCACAGGACCCGCAGGGGT	5	4	27	25	22	er	independent
seq897_all_clean_seqs_gap0_no20_0.4	GAGAACTTCCGGTGCGCTCCCCGGGACTGCGGTCCC	8	6	30	28	22	er	independent
seq898_all_clean_seqs_gap0_no20_0.4	GCAGAGAGGAAGTGTGGGGGTGGAGGAGGCCGCAGA	8	7	30	28	22	er	independent
seq899_all_clean_seqs_gap0_no20_0.4	TGGAGTGAAGCGGCTTCCTTGCGGTTGTGTGCGTGT	16	14	22	20	6	er	cooperative
seq89_all_clean_seqs_gap0_no20_0.4	TGCCTGGAAGACGGAAGGCAGGTGGTTGGCTCTAGT	13	12	23	21	10	er	independent
seq900_all_clean_seqs_gap0_no20_0.4	CCAGCCGGAAGCCCCGCCCCCTAGAGGCACCGCGGA	7	6	30	28	23	er	independent
seq901_all_clean_seqs_gap0_no20_0.4	GCCTGAAGGACTTCCGGGAACCGCAAAGCACGGTGT	13	11	21	19	8	er	cooperative
seq902_all_clean_seqs_gap0_no20_0.4	TTCTTCACTTCCTTCTCTCCGTGGTTTCGCCATTAG	10	8	22	20	12	er	independent
seq903_all_clean_seqs_gap0_no20_0.4	GCCACACTTCCGGCGGGGCTGCGACCGCAGAGGGGC	9	7	25	23	16	er	cooperative
seq904_all_clean_seqs_gap0_no20_0.4	GGCCCCTGCTTCCGGGTGTGACGCGAACCGCGGGCA	11	9	28	26	17	er	independent
seq905_all_clean_seqs_gap0_no20_0.4	CAGCGGCCGTCGCGGGAAGTGCGGTCGCCGCGGCCA	15	14	22	20	7	er	independent
seq906_all_clean_seqs_gap0_no20_0.4	TCCTCCGTTTCCGTAGTTCCGAGTTGCGGTTTCTCC	10	8	27	25	17	er	cooperative
seq907_all_clean_seqs_gap0_no20_0.4	CAACCCGGAAGCACTAACGGAGAAACCGCAACTCGG	7	6	26	24	19	er	cooperative
seq908_all_clean_seqs_gap0_no20_0.4	GGGCTTCAGCGGATGAACAAGGTTACCACGGGGAGT	11	10	26	24	15	er	independent
seq909_all_clean_seqs_gap0_no20_0.4	GGGCAGCAGCAGACCGGAAACCACAGCCGACTAAGA	16	15	21	19	5	er	cooperative
seq90_all_clean_seqs_gap0_no20_0.4	TCAGGGTCAGCAGGAGGAAACCACGCACTACATGCT	16	15	21	19	5	er	independent
seq910_all_clean_seqs_gap0_no20_0.4	CTAGCCAGGAAGATAAAGAAGAAACCACCAAAGAGA	8	7	25	23	17	er	independent
seq912_all_clean_seqs_gap0_no20_0.4	CCATTCTTCCGGTGGAGATGGCTGCGGCCGTGGCGG	8	6	25	23	17	er	independent
seq913_all_clean_seqs_gap0_no20_0.4	ACTCCCTAGAGCAGGAAGCCTGTGGTTTGTAATTGG	14	13	23	21	9	er	cooperative
seq915_all_clean_seqs_gap0_no20_0.4	CTCCACCGGATGCAGCAATGAAGGCCGCAGGAATGG	8	7	25	23	17	er	independent
seq916_all_clean_seqs_gap0_no20_0.4	TGCGCCGCTTCCGCTGCCCGAGGAAGAGCCGCAGTC	10	8	29	27	19	er	independent
seq918_all_clean_seqs_gap0_no20_0.4	CCGATGGCGGCGGAACTGTGGTCAGGGCTGCCCTGA	12	11	19	17	7	er	cooperative
seq919_all_clean_seqs_gap0_no20_0.4	GAGCGCAGGACGGAAGCTCGGTGCGGGTGCGGCCTC	12	11	24	22	12	er	independent
seq920_all_clean_seqs_gap0_no20_0.4	GGAGGAAGTGACACCCACCCACTGCCCCCGCAAGGT	4	3	28	26	24	er	independent
seq922_all_clean_seqs_gap0_no20_0.4	CTCTTCCAGGAAGCCTTCCCTGACCACTGCTTGCTC	9	8	24	22	15	er	independent
seq923_all_clean_seqs_gap0_no20_0.4	AGCCCGGCTTCCGGCGCGTGCCGCTGCGGCTGCAGG	10	8	27	25	17	er	independent
seq926_all_clean_seqs_gap0_no20_0.4	CCTGCCTTCCGTCTTCCAGGCAGAACCACAGAGAGG	8	6	26	24	18	er	independent
seq928_all_clean_seqs_gap0_no20_0.4	GAAGTCACATCCTGTCTGTTGCGGCAGGGCACAGAG	10	8	22	20	12	er	ambiguous
seq929_all_clean_seqs_gap0_no20_0.4	TCTAGTAAAAGAGGAAGTTCTTAACCACATTTCCAT	13	12	25	23	12	er	cooperative
seq930_all_clean_seqs_gap0_no20_0.4	GCCGTGAGAAACATCCTGCCTAACCACCTGACTACA	14	12	24	22	10	er	independent
seq931_all_clean_seqs_gap0_no20_0.4	TATCACATCCTGCCGGACAAAAAGGCCAAACCACCT	8	6	31	29	23	er	independent
seq932_all_clean_seqs_gap0_no20_0.4	TGTTTGTTTCCGAAGATTAGCCAGCCTGCGGTAGAG	9	7	29	27	20	er	independent
seq934_all_clean_seqs_gap0_no20_0.4	GCCCCAGCGTTTCCTCTTACCCACAATGCCCCGCCC	12	10	21	19	9	er	independent
seq936_all_clean_seqs_gap0_no20_0.4	TCCAGCCGGACGCGATGCCTGGAGGCTGCGGGCGCC	8	7	29	27	21	er	cooperative
seq937_all_clean_seqs_gap0_no20_0.4	GCTGTTTCCTGCTGATAAAAACACCCCACAACTTCA	7	5	26	24	19	er	independent
seq938_all_clean_seqs_gap0_no20_0.4	GGCATTCACTTCCGGTCTGGGGCCTGCGGCGGCGGC	11	9	27	25	16	er	independent
seq939_all_clean_seqs_gap0_no20_0.4	TTCAAAGGAGTCCAAGGAAGTGGTTTAACAGCGATG	16	15	21	19	5	er	cooperative
seq93_all_clean_seqs_gap0_no20_0.4	CTGCCGCGACAGACAGGATGTGGCTTCTGCTCTGTC	16	15	21	19	5	er	independent
seq940_all_clean_seqs_gap0_no20_0.4	CACTTCCTATCGCTACATAACAAATTACCACAGACT	5	3	28	26	23	er	cooperative
seq942_all_clean_seqs_gap0_no20_0.4	GGGCCAGAGACGCCGGAAGTGACCGCGCGGTGCGCC	15	14	23	21	8	er	independent
seq943_all_clean_seqs_gap0_no20_0.4	CTCCTTCCTGATCGGGCAGGAACTAACCACAGGAGG	6	4	27	25	21	er	cooperative
seq944_all_clean_seqs_gap0_no20_0.4	GTGCTAAGTGAGGAAGTGCAGTTTACCGCACGGTGG	12	11	26	24	14	er	cooperative
seq945_all_clean_seqs_gap0_no20_0.4	CGATTCCGGAGACAGGCCCCACCGTGCGGTAAACTG	5	3	27	25	22	er	cooperative
seq946_all_clean_seqs_gap0_no20_0.4	GACCCGGCCCGCCCCTTCCGGCCGCAGCGCGGGGCA	17	15	22	20	5	er	independent
seq94_all_clean_seqs_gap0_no20_0.4	CTTCCTTCCCTTCCTTCTGCTCCCTCCCACAGCCGC	12	10	27	25	15	er	independent
seq951_all_clean_seqs_gap0_no20_0.4	CCTGTTCCGGGCTCCGTACACCCAGGCCCGCAGCTG	6	4	28	26	22	er	independent
seq952_all_clean_seqs_gap0_no20_0.4	CTAGTTTCCTGTGGCTGCTATGACAAATGACCACAG	7	5	31	29	24	er	independent
seq953_all_clean_seqs_gap0_no20_0.4	TCGCTTCCGGTGTCGGTTACAGACTGTGGTTGCCAT	6	4	27	25	21	er	ambiguous
seq954_all_clean_seqs_gap0_no20_0.4	TGGTGCCAAACATCCGCTAGCCACAGAAAAACCGAC	13	11	21	19	8	er	independent
seq955_all_clean_seqs_gap0_no20_0.4	CGAAAGTGACCGGAAGTAACCGCCGGGCCAAGATGG	12	11	20	18	8	er	independent
seq956_all_clean_seqs_gap0_no20_0.4	AGGTTCCGGCGAAAGTGACCGAAAGTAACCGCCGGG	5	3	29	27	24	er	independent
seq957_all_clean_seqs_gap0_no20_0.4	CGGCGCGGCGGACGTTGCTGCGGTAGGACGTGCCCG	10	9	21	19	11	er	independent
seq959_all_clean_seqs_gap0_no20_0.4	ACAGATCCAAGGAAGCATATCCCGCAAGCAACTGTT	11	10	22	20	11	er	independent
seq962_all_clean_seqs_gap0_no20_0.4	CAATGGATGGCCACATCCTCACCACAAACTGAGTCA	16	14	22	20	6	er	cooperative
seq963_all_clean_seqs_gap0_no20_0.4	GAACATGGTCTCCGCTTCCGCCGCAACCTCGGCCTT	17	15	21	19	4	er	independent
seq964_all_clean_seqs_gap0_no20_0.4	AGTGGAGTAGGAACCGGAAAACCACAATAAGTCCCA	16	15	22	20	6	er	cooperative
seq965_all_clean_seqs_gap0_no20_0.4	TGAAGCAGGCGGAAGTGCTGTGGTTTCTGGCGACTG	11	10	21	19	10	er	cooperative
seq967_all_clean_seqs_gap0_no20_0.4	AACAGTTGCATAGGAAGTGGTCAGCTCTCCTCCACC	13	12	18	16	5	er	cooperative
seq968_all_clean_seqs_gap0_no20_0.4	TACCATAAAACTTCCCTGGGGAAACCGCCCACTCCC	13	11	25	23	12	er	independent
seq96_all_clean_seqs_gap0_no20_0.4	CCCCTTCATCCGCCTCTCTCTCACCGCGCCGCTCCC	9	7	24	22	15	er	ambiguous
seq971_all_clean_seqs_gap0_no20_0.4	CAGAGCCAAACATGCGGAAGTGGTTACGTGTACTAG	16	15	21	19	5	er	cooperative
seq972_all_clean_seqs_gap0_no20_0.4	GAGCACATTTCCTTTTGCTTCCAGATACCACAGTGA	10	8	28	26	18	er	independent
seq973_all_clean_seqs_gap0_no20_0.4	GCCAACAGGAAGCTGGAAGCCAACCGCACTGTGTGC	8	7	24	22	16	er	cooperative
seq974_all_clean_seqs_gap0_no20_0.4	GGCTTTCCGTTCAAGGATCTTTTTGCGGTCTTTGTC	6	4	26	24	20	er	cooperative
seq976_all_clean_seqs_gap0_no20_0.4	GCTGATAGAACAGGATGTGGTAAAGAAGCAGGCCAA	13	12	18	16	5	er	cooperative
seq978_all_clean_seqs_gap0_no20_0.4	CCTGTTGATAAAACAGGATGTGGTAAAGAAGCTGGC	16	15	21	19	5	er	cooperative
seq979_all_clean_seqs_gap0_no20_0.4	GCGCCCCGCTTCCGGGGCCGCCCTAAACCGCGGCCG	11	9	28	26	17	er	cooperative
seq981_all_clean_seqs_gap0_no20_0.4	CCCGCTACACAAGGCGGATGTGGTACCCTCACTTGT	16	15	21	19	5	er	ambiguous
seq982_all_clean_seqs_gap0_no20_0.4	GTCTTAGGTCGGAAGTCTGTGGTCCCTGTTCACATG	11	10	20	18	9	er	independent
seq985_all_clean_seqs_gap0_no20_0.4	AGTCCACACTACAGGAAACCACAGGCCTGAGCCCCA	14	13	19	17	5	er	cooperative
seq987_all_clean_seqs_gap0_no20_0.4	TAGTCCGCTACAGGAAGGTGGTCATCCTCGGATACC	13	12	19	17	6	er	independent
seq988_all_clean_seqs_gap0_no20_0.4	TGGCTTATCCTAACAGGAAGTGGTTTATCTGATCCT	16	15	21	19	5	er	cooperative
seq989_all_clean_seqs_gap0_no20_0.4	GCGGAGGCGGAAGTCGTGCTGCTGCTGACCACGGCT	9	8	29	27	20	er	cooperative
seq98_all_clean_seqs_gap0_no20_0.4	GACCGAGAGGAAGCAGCAAGGATCCTGCGGTTCCAG	9	8	28	26	19	er	cooperative
seq991_all_clean_seqs_gap0_no20_0.4	GTACTGAGTCACAGGAAACCACAAGGGAAGGGTCCC	14	13	19	17	5	er	cooperative
seq994_all_clean_seqs_gap0_no20_0.4	CTACATGTTTCACAGGAAGGTGGTCACCAGGAGGCA	15	14	21	19	6	er	independent
seq996_all_clean_seqs_gap0_no20_0.4	GTCCCTGTTTCCTCCCTCAGCTCCCGCAACCTCCGG	10	8	24	22	14	er	ambiguous
seq997_all_clean_seqs_gap0_no20_0.4	ATCAGTCAACTTCCCCCACTCCCTCCCACAAAGAAA	12	10	26	24	14	er	independent
seq998_all_clean_seqs_gap0_no20_0.4	AGCTCCCCTCCCCGGAAACTTGACCACCTAGCCCAG	14	13	24	22	10	er	independent
