Name	Sequence	runx1_pos	runx1_start	ets1_pos	ets1_start	distance	ori	label
seq1001_all_clean_seqs_gap0_no20_0.4	CCGGTCCGCTCGCCGGAAATGCGGGCTCTCCTGCCG	22	20	15	14	7	er	cooperative
seq1002_all_clean_seqs_gap0_no20_0.4	GGGGCAGCTTCCGGCAGGAGAGCCCGCATTCACGGC	24	22	10	8	14	er	cooperative
seq1003_all_clean_seqs_gap0_no20_0.4	GGCTGGGGCGGTATCCTGTGGTCTTACTCTGGTGAC	19	17	14	12	5	er	cooperative
seq1004_all_clean_seqs_gap0_no20_0.4	CCGCCCTAGAGCAGGAAATAGCGGTCAGCGCCAGCT	22	20	14	13	8	er	cooperative
seq1005_all_clean_seqs_gap0_no20_0.4	CTGCGTTTCCTCTGAGTTTTGCATGTTGAGGTTGGA	29	27	8	6	21	er	cooperative
seq1008_all_clean_seqs_gap0_no20_0.4	CCGGGCTGCGGAAGGCGGGAATTCTGCGGTTCGCGG	27	25	10	9	17	er	ambiguous
seq1298_all_clean_seqs_gap0_no20_0.4	CCGGGCTGCGGAAGGCGGGAATTCTGCGGTTCGCGG	27	25	10	9	17	er	independent
seq1009_all_clean_seqs_gap0_no20_0.4	GCTGCAGCAGGCGGGAAGTCTGCGGTTCGCGGGCTC	23	21	14	13	9	er	cooperative
seq1299_all_clean_seqs_gap0_no20_0.4	GCTGCAGCAGGCGGGAAGTCTGCGGTTCGCGGGCTC	23	21	14	13	9	er	cooperative
seq1017_all_clean_seqs_gap0_no20_0.4	AATCCACCGGAAACACTTAGACGCCGCAACCCCAGT	24	22	9	8	15	er	cooperative
seq101_all_clean_seqs_gap0_no20_0.4	AGTCTCGTTTCCTGTGCGCTGTGGCCACCTGGCAGC	22	20	10	8	12	er	cooperative
seq1020_all_clean_seqs_gap0_no20_0.4	CAGCCGACTTCCGGGGTGGGGCTTGCTGCCGCAGAG	29	27	10	8	19	er	cooperative
seq1026_all_clean_seqs_gap0_no20_0.4	TTGCACACGTGGGCGGGAAGTGGTTAAGCGGCCTCA	21	19	16	15	5	er	cooperative
seq1030_all_clean_seqs_gap0_no20_0.4	GCAGAAACAGGAAGAGACAGGGCTGACCGCAGCAGG	27	25	10	9	17	er	cooperative
seq1032_all_clean_seqs_gap0_no20_0.4	CAGAGAAACAGGAAGAACAGTGGTTTCAACTGAAAT	21	19	11	10	10	er	ambiguous
seq1034_all_clean_seqs_gap0_no20_0.4	ACAGATAGTGATATCCTGTGGTCAATTCCCTCCCCT	19	17	14	12	5	er	cooperative
seq1035_all_clean_seqs_gap0_no20_0.4	GCCGTCACTTCCGTCATTCAAACCGCCCGCCAATGG	23	21	10	8	13	er	cooperative
seq1036_all_clean_seqs_gap0_no20_0.4	CGAGATCCTGGCCACGGATGCGGTGGCCGCGCCTCT	21	19	16	15	5	er	independent
seq1039_all_clean_seqs_gap0_no20_0.4	GTCCCCTGAATTTTCCTGTGGTTCTTATCACCAGGT	19	17	14	12	5	er	independent
seq1040_all_clean_seqs_gap0_no20_0.4	CCCATCCATCCGCCTCCAAAGTAACCTCAAGAATTT	25	23	9	7	16	er	independent
seq1041_all_clean_seqs_gap0_no20_0.4	GAGGCAGGCGGATGTCAGTGTGGTTAGAGCACAGTG	21	19	10	9	11	er	cooperative
seq1042_all_clean_seqs_gap0_no20_0.4	AGGCTTCCGGCCACGCCCCCTTCCCGCGGTTGCTAG	27	25	6	4	21	er	cooperative
seq1044_all_clean_seqs_gap0_no20_0.4	TTACTGCCGGAACTTGGGACCTTTGTAACCACGTCT	29	27	9	8	20	er	independent
seq1046_all_clean_seqs_gap0_no20_0.4	CTAACCCTTCTCTTCCTGCAAAAACCACAACAAAGG	25	23	14	12	11	er	cooperative
seq1302_all_clean_seqs_gap0_no20_0.4	CTAACCCTTCTCTTCCTGCAAAAACCACAACAAAGG	25	23	14	12	11	er	independent
seq1048_all_clean_seqs_gap0_no20_0.4	TTGACCCGGACGTGGACAAAAGACCGCAAAGGACGC	24	22	8	7	16	er	ambiguous
seq1049_all_clean_seqs_gap0_no20_0.4	CCCATTTCCGAGAGTGGCAGGGCTGGGCGCGGTGGG	30	28	7	5	23	er	cooperative
seq1050_all_clean_seqs_gap0_no20_0.4	TTGTGCTTCCTGCTCATGAGATTGCTAGCGGTTACT	29	27	8	6	21	er	cooperative
seq1303_all_clean_seqs_gap0_no20_0.4	TTGTGCTTCCTGCTCATGAGATTGCTAGCGGTTACT	29	27	8	6	21	er	cooperative
seq1051_all_clean_seqs_gap0_no20_0.4	AGCGCCACACTTCCGCTTTGCGGCAGTGTGCGCCCC	21	19	12	10	9	er	cooperative
seq1057_all_clean_seqs_gap0_no20_0.4	CTGTCATCTTCCTGACAGCACGCCCACAAAGGACCA	24	22	10	8	14	er	independent
seq1059_all_clean_seqs_gap0_no20_0.4	ACGCGCTCCCTCACTTCCTGCGGCTTTTGGTCCCTC	21	19	16	14	5	er	cooperative
seq1060_all_clean_seqs_gap0_no20_0.4	TGGCGGGAGAACTTCCCCCTGTGCGGTCGCGACGTG	24	22	14	12	10	er	cooperative
seq1061_all_clean_seqs_gap0_no20_0.4	ATCTTAAGTGTTTCCTGACACCACAAATCCCCAAAC	21	19	13	11	8	er	independent
seq1063_all_clean_seqs_gap0_no20_0.4	AACTAGAGCGTCATTTCCTGTGGGTACAAGTCCAGT	21	19	16	14	5	er	cooperative
seq1065_all_clean_seqs_gap0_no20_0.4	GCTGATAAAACAGGATGTGGTAAAGAAGCCGGCCAA	18	16	13	12	5	er	cooperative
seq1069_all_clean_seqs_gap0_no20_0.4	TGATAAAACACAGGATGTGGTAAGGGAGCTGGCCAA	18	16	13	12	5	er	cooperative
seq106_all_clean_seqs_gap0_no20_0.4	CAGAGAGAGGCCACATCCCTGTGGTCACACATACCC	22	20	16	14	6	er	independent
seq1070_all_clean_seqs_gap0_no20_0.4	GGAGGTGGGGAGGAAGTTCTGAAACCACACACATTT	25	23	12	11	13	er	cooperative
seq1075_all_clean_seqs_gap0_no20_0.4	GTCTTACTTCCTGTCCCCGCCCACCGCGACTGTCTT	24	22	9	7	15	er	cooperative
seq1079_all_clean_seqs_gap0_no20_0.4	AGAATCGCATCAGGATGTGGTGAGGGAGCACATTTG	18	16	13	12	5	er	cooperative
seq1084_all_clean_seqs_gap0_no20_0.4	CTCAGCTCCGCGGAAGTTGCGGTAAGTGGAGCTTTG	20	18	12	11	8	er	independent
seq1085_all_clean_seqs_gap0_no20_0.4	ACAACCCGGAAGTTGGCGCAGCGCGGTTGCCAATGG	24	22	8	7	16	er	cooperative
seq1086_all_clean_seqs_gap0_no20_0.4	TGGCGCTTCCTGTCGCTACCGCTGCGGCCCAGGGCC	25	23	8	6	17	er	cooperative
seq1088_all_clean_seqs_gap0_no20_0.4	GCCATGGCCACTTCCTGCTTGTAACCACAGCCCAGA	25	23	13	11	12	er	cooperative
seq108_all_clean_seqs_gap0_no20_0.4	ACGGTGCGTTTCCCCAACTACACCGCACGTCACGGA	23	21	11	9	12	er	independent
seq1091_all_clean_seqs_gap0_no20_0.4	TATGGCGGGCAGGAAGTGCGGGTGCGCGCCTGCGCA	19	17	12	11	7	er	cooperative
seq1092_all_clean_seqs_gap0_no20_0.4	AATAAAGCTACAGACTTCCGCCCACAGGTCGCCGCT	22	20	17	15	5	er	cooperative
seq1308_all_clean_seqs_gap0_no20_0.4	AATAAAGCTACAGACTTCCGCCCACAGGTCGCCGCT	22	20	17	15	5	er	cooperative
seq1094_all_clean_seqs_gap0_no20_0.4	TTTGTCATATCAACAGGATGTGGTTCTCCCCTGGTT	21	19	16	15	5	er	cooperative
seq1096_all_clean_seqs_gap0_no20_0.4	CCCCTCACTTCCCTCAACCCTTCCCACAAACTGGGA	24	22	10	8	14	er	cooperative
seq1098_all_clean_seqs_gap0_no20_0.4	CCACCATCTTTCCGGCTCCCTCGCGACCACCACGAC	27	25	11	9	16	er	cooperative
seq1101_all_clean_seqs_gap0_no20_0.4	ATCTTACCCCGGAAATGACAACAGTGCCGCAAACTG	27	25	11	10	16	er	cooperative
seq1102_all_clean_seqs_gap0_no20_0.4	TTAGAGCTGACATCCTTGCGGTCCACAGCCTCCAAA	19	17	13	11	6	er	independent
seq1103_all_clean_seqs_gap0_no20_0.4	ACTCACACCACGGAAACTGCGGCTCGGCAGGCTGAG	20	18	12	11	8	er	independent
seq1105_all_clean_seqs_gap0_no20_0.4	CCTGGTCCGGAAGCGCTGTCCCCGCCTCCCGCATAG	29	27	9	8	20	er	cooperative
seq1106_all_clean_seqs_gap0_no20_0.4	AACAACTGACCGGACAGAACACAGCCACAAAACACG	25	23	12	11	13	er	independent
seq1312_all_clean_seqs_gap0_no20_0.4	AACAACTGACCGGACAGAACACAGCCACAAAACACG	25	23	12	11	13	er	independent
seq1107_all_clean_seqs_gap0_no20_0.4	GTAAAAGAGGAAGTAACACCTCCTTGCGGTTGAGAC	27	25	9	8	18	er	cooperative
seq1109_all_clean_seqs_gap0_no20_0.4	CAACTGACCGGACAGAACACAGCCACAAAACACGAG	23	21	10	9	13	er	independent
seq1311_all_clean_seqs_gap0_no20_0.4	CAACTGACCGGACAGAACACAGCCACAAAACACGAG	23	21	10	9	13	er	independent
seq110_all_clean_seqs_gap0_no20_0.4	TGTCTTCAGGAAGTGTAGCAGGTGTTGAGGTCAAGC	28	26	9	8	19	er	cooperative
seq329_all_clean_seqs_gap0_no20_0.4	TGTCTTCAGGAAGTGTAGCAGGTGTTGAGGTCAAGC	28	26	9	8	19	er	independent
seq1111_all_clean_seqs_gap0_no20_0.4	GCCCCGGAAGTGGCCCGGCTGTTGGCCGCAGCGGGA	26	24	6	5	20	er	cooperative
seq1116_all_clean_seqs_gap0_no20_0.4	AACTAGGCTTTTCTTTCCTGTGGTCCTTAAGGAGGC	21	19	16	14	5	er	independent
seq1117_all_clean_seqs_gap0_no20_0.4	CCACCGTCCCCGGAAATAACCGCGCCTGCCTCTCAA	20	18	12	11	8	er	cooperative
seq1118_all_clean_seqs_gap0_no20_0.4	GCTCGGAAATACCAATATTGGGCTGTGGTATTTGAA	26	24	5	4	21	er	independent
seq1121_all_clean_seqs_gap0_no20_0.4	ACGGGGAAGAACGGAAGTGGTTTCCATGATGGTCTG	18	16	13	12	5	er	cooperative
seq1316_all_clean_seqs_gap0_no20_0.4	ACGGGGAAGAACGGAAGTGGTTTCCATGATGGTCTG	18	16	13	12	5	er	cooperative
seq1123_all_clean_seqs_gap0_no20_0.4	GCCAGGAGGACTTCCGGGTGGGTGTGGTATCTGCGA	25	23	13	11	12	er	cooperative
seq1124_all_clean_seqs_gap0_no20_0.4	TCCAGTGCCGCCGCCGGAAAACCGCAGCGGCGGCGG	22	20	16	15	6	er	ambiguous
seq1126_all_clean_seqs_gap0_no20_0.4	GCACCCTTCCTGCTTCCCACAGTGTGGTATAAGAGG	25	23	8	6	17	er	cooperative
seq1130_all_clean_seqs_gap0_no20_0.4	CCCGCCACTTCCCTGCCTCTGCGGGAGCCCCCCAGC	22	20	10	8	12	er	cooperative
seq1132_all_clean_seqs_gap0_no20_0.4	GGGCTATTGTTTCCTCCCCCATGTGACCACAGCCTC	27	25	12	10	15	er	independent
seq1134_all_clean_seqs_gap0_no20_0.4	GAGGAAGAGTCTTCCTGTAACCACTAGAGGGCGCTG	21	19	13	11	8	er	cooperative
seq1135_all_clean_seqs_gap0_no20_0.4	CCACCCTCCGTCCGGCCGCGACCGCGAGGAGGAAGA	22	20	11	9	11	er	cooperative
seq1136_all_clean_seqs_gap0_no20_0.4	CCCACTGATAAGACAGGATGTGGTAAAGAAGCCAGC	21	19	16	15	5	er	cooperative
seq1137_all_clean_seqs_gap0_no20_0.4	ACCTGCACTTCCTCCTCCCTAGACCGCACCCTTCTC	24	22	10	8	14	er	cooperative
seq1138_all_clean_seqs_gap0_no20_0.4	GCCACTTCCGGTCACTCCCCGCTGCGGCCTCGCGCT	25	23	7	5	18	er	cooperative
seq1140_all_clean_seqs_gap0_no20_0.4	ATCCCACTATAGGAAGCTTCTCTGTGGTTTTGAGCC	25	23	12	11	13	er	independent
seq1143_all_clean_seqs_gap0_no20_0.4	CTTTGCAGGAAGCTGGGGTTCACCCACAGCCTTGTT	24	22	8	7	16	er	independent
seq1144_all_clean_seqs_gap0_no20_0.4	ACAACTTCCTGTGGGATTTTTGGTGTCTGCGGCTCA	30	28	7	5	23	er	cooperative
seq1145_all_clean_seqs_gap0_no20_0.4	CACTTCCTGCCCTCTTCCACTTTCAAAACCACATCA	29	27	5	3	24	er	cooperative
seq1148_all_clean_seqs_gap0_no20_0.4	ACCTCTCTCACTTCCTACCAGAGAACCACAGCCAAG	26	24	13	11	13	er	cooperative
seq1149_all_clean_seqs_gap0_no20_0.4	CCTCAATTTCCTGGCCAGAGAAACCACTGCCTCTCA	24	22	9	7	15	er	cooperative
seq1150_all_clean_seqs_gap0_no20_0.4	CGAAGCCAGGAAATAAGGATAAACCACAGAAAGAAA	24	22	9	8	15	er	independent
seq1151_all_clean_seqs_gap0_no20_0.4	GAGTCTACAGCGGAAGCCACCACATGCCCCACCCCC	20	18	12	11	8	er	cooperative
seq1153_all_clean_seqs_gap0_no20_0.4	GTGGGGGTGACAGGATGCGGGTAGAGGGCTCAGCCA	18	16	13	12	5	er	cooperative
seq1154_all_clean_seqs_gap0_no20_0.4	TAAGAAAAACAGTCATCCTGCGGTTTCCATTTGTGA	21	19	16	14	5	er	independent
seq1155_all_clean_seqs_gap0_no20_0.4	TCCCTCCTTCCGCTCTGGTTTTGTGGTTGCTTGCTG	24	22	9	7	15	er	cooperative
seq1156_all_clean_seqs_gap0_no20_0.4	GACAGACCTTAGGAAGTCGCGGTTTCATCAGGGCTT	20	18	12	11	8	er	cooperative
seq1157_all_clean_seqs_gap0_no20_0.4	GGCAACCCAAGGAAGTATCTCTGAAACCACACAACA	27	25	11	10	16	er	independent
seq1159_all_clean_seqs_gap0_no20_0.4	TGTAAGTCACTTCCTGTCGTGGTCAGGTCTCCTCTC	20	18	12	10	8	er	cooperative
seq1160_all_clean_seqs_gap0_no20_0.4	GATGAAAGAGGAAGTTCTCAAACCACCTTGCCAGTG	23	21	10	9	13	er	cooperative
seq1161_all_clean_seqs_gap0_no20_0.4	ACCATATCCTGAGAATGAACCATGTGGTGGATGCAC	25	23	7	5	18	er	cooperative
seq1162_all_clean_seqs_gap0_no20_0.4	AAACCAGAGGAAGTGGATTCCAACCACAAACCTCAC	24	22	9	8	15	er	cooperative
seq1163_all_clean_seqs_gap0_no20_0.4	ACTTACAAAGGAAGTGACAGAACCACAGAAAAGACC	23	21	10	9	13	er	cooperative
seq1165_all_clean_seqs_gap0_no20_0.4	ACAGAGAAGCTTCCTATTGTGGGATTCACCACCACC	20	18	12	10	8	er	ambiguous
seq1167_all_clean_seqs_gap0_no20_0.4	AGGAGAAGGAAGAGGATGTTGAGGTTGGGGGAAACC	22	20	14	13	8	er	independent
seq1171_all_clean_seqs_gap0_no20_0.4	GTCCCCGTAACAGGATGTGGTGAGCTGTTATACCAC	18	16	13	12	5	er	cooperative
seq1172_all_clean_seqs_gap0_no20_0.4	TTCATTTCTACCTTCCTGTGGTCTTTTTGCCTCCGA	19	17	14	12	5	er	independent
seq1173_all_clean_seqs_gap0_no20_0.4	GCAGAGAGATTGGCCGGATGCGGTGGCTCACGCCTT	21	19	16	15	5	er	cooperative
seq1176_all_clean_seqs_gap0_no20_0.4	TCCGGAAGTGGCACTGATGGGCGCCTGCGGCGGGGG	28	26	4	3	24	er	cooperative
seq1177_all_clean_seqs_gap0_no20_0.4	AATGCCGGATATTGGTTCTGGTAAGCCACAAAAAAG	26	24	7	6	19	er	cooperative
seq1178_all_clean_seqs_gap0_no20_0.4	CTGTCCCTAGCAGGATGTGGTTTGCACATTGCTGCT	18	16	13	12	5	er	cooperative
seq117_all_clean_seqs_gap0_no20_0.4	GGGGGAAGCTTCCTGAGGTGAAATAGACCGCTGTGC	28	26	11	9	17	er	independent
seq1180_all_clean_seqs_gap0_no20_0.4	CGGGGGCCAGGCTTCCTGTGGTGGGAGCGGCAGGCC	19	17	14	12	5	er	cooperative
seq1181_all_clean_seqs_gap0_no20_0.4	CTTAGCACTTCAGCCGGAAACCACAGCATACATTTC	21	19	16	15	5	er	cooperative
seq1182_all_clean_seqs_gap0_no20_0.4	CTTGTGAAATGTATCCTGTGGTTGCCGGCTGAAGTG	19	17	14	12	5	er	cooperative
seq1183_all_clean_seqs_gap0_no20_0.4	GAGGGACAGGATGCCGCCAGGAACCACAAGAGCTTC	24	22	9	8	15	er	cooperative
seq1289_all_clean_seqs_gap0_no20_0.4	GAGGGACAGGATGCCGCCAGGAACCACAAGAGCTTC	24	22	9	8	15	er	cooperative
seq1184_all_clean_seqs_gap0_no20_0.4	ATGGGTACAGGATTTCCTTTTGTGGTGATGAAAATG	23	21	15	13	8	er	cooperative
seq1185_all_clean_seqs_gap0_no20_0.4	CAGCGGAAGAAAGACCTGCCACCTCCACCACAAAGA	28	26	5	4	23	er	independent
seq1186_all_clean_seqs_gap0_no20_0.4	TGGGGACCACTGTCAGGATGTGGTCACTGGAGTCAC	21	19	16	15	5	er	cooperative
seq1187_all_clean_seqs_gap0_no20_0.4	CGGGGACCACTGTCAGGATGTGGTCACTGGAGTCAC	21	19	16	15	5	er	cooperative
seq1188_all_clean_seqs_gap0_no20_0.4	TATTCTTCCTGTACTTAAGCTTGCTGGTGTGGTTTC	30	28	7	5	23	er	cooperative
seq1189_all_clean_seqs_gap0_no20_0.4	AGAAAAGGAAATGGTGGGCTGCACACCACAGCTCAC	26	24	7	6	19	er	cooperative
seq1190_all_clean_seqs_gap0_no20_0.4	CACTTCCTGTCAAAGCCAGTTCCTTAACCGCTTAGG	28	26	5	3	23	er	cooperative
seq1191_all_clean_seqs_gap0_no20_0.4	CAGGTTGTTGAGGATGTGGAGAAACCGCAACCTCGT	25	23	12	11	13	er	independent
seq1192_all_clean_seqs_gap0_no20_0.4	CCAGGGCCGGAAGTGCTGGTGGTGGTTTCCATCATG	23	21	9	8	14	er	cooperative
seq1194_all_clean_seqs_gap0_no20_0.4	AGTTGGTTCCTTCCGGTGGGTTTGTGGGCTTGGGGT	25	23	12	10	13	er	cooperative
seq1195_all_clean_seqs_gap0_no20_0.4	GCAACTGAACAGGAAACTAAAAAACCACAACACTTA	25	23	12	11	13	er	cooperative
seq1196_all_clean_seqs_gap0_no20_0.4	CCCTCACCCCAGCTTTCCTGTGGTTAACCAAACCCC	21	19	16	14	5	er	independent
seq1198_all_clean_seqs_gap0_no20_0.4	GTGTGAAGGAAGTGTGAGATCAAACCACAGCTGGGT	25	23	8	7	17	er	ambiguous
seq1199_all_clean_seqs_gap0_no20_0.4	TGGAAGAGGGCAGGAAGTGTTGTGGTCACTCCCACC	23	21	13	12	10	er	cooperative
seq1200_all_clean_seqs_gap0_no20_0.4	CAAGGGAACATCCTTAAACAGCTTGTGGTATTGCTG	26	24	11	9	15	er	cooperative
seq1201_all_clean_seqs_gap0_no20_0.4	TGTTGTAGGGGAAGTGGTGTGTGGTATTCCTGGGGA	22	20	10	9	12	er	ambiguous
seq1203_all_clean_seqs_gap0_no20_0.4	TACGGGAACTTCCTTTTCTTGTGGTGTGGCCGGGTC	22	20	11	9	11	er	cooperative
seq1205_all_clean_seqs_gap0_no20_0.4	CACTGCGGAAGCAGTGTAGAGAGGTGGTTATCAGTG	25	23	7	6	18	er	independent
seq1206_all_clean_seqs_gap0_no20_0.4	CTGCTGCTTTTAGGATGTGGTTTTATTATTGTCGGG	18	16	13	12	5	er	cooperative
seq1207_all_clean_seqs_gap0_no20_0.4	GAGAAACAGGAAGAGGGGTGGTGGTTACGGAACACG	22	20	9	8	13	er	cooperative
seq120_all_clean_seqs_gap0_no20_0.4	TTTATCATGAATGCAGGATGTGGGCAGACTCACAGC	21	19	16	15	5	er	cooperative
seq1212_all_clean_seqs_gap0_no20_0.4	GGCAAACAGGAAACACTCCCAGGGCTGTGGGCTCCT	28	26	9	8	19	er	cooperative
seq1214_all_clean_seqs_gap0_no20_0.4	GGGCTCCCAGAAGGATGTGGTTTCTGAGTACGTTGG	18	16	13	12	5	er	cooperative
seq1296_all_clean_seqs_gap0_no20_0.4	GGGCTCCCAGAAGGATGTGGTTTCTGAGTACGTTGG	18	16	13	12	5	er	cooperative
seq1215_all_clean_seqs_gap0_no20_0.4	ACCAGCAACGGAAATCAGATCTCTTGTGGTTATTAT	27	25	10	9	17	er	cooperative
seq1217_all_clean_seqs_gap0_no20_0.4	CAAGCCAGGAAGAGGGCCCTCACCAGAAACCGCACT	30	28	8	7	22	er	cooperative
seq1220_all_clean_seqs_gap0_no20_0.4	CAGCAAAAGGCAGGATGTGGTTAAAACTGTGCTCTG	18	16	13	12	5	er	cooperative
seq1222_all_clean_seqs_gap0_no20_0.4	CCAAAATTGCCACGGAAACCACATCTTTCAGGCGAG	19	17	14	13	5	er	independent
seq1223_all_clean_seqs_gap0_no20_0.4	TCTCCTTTCAGGAAGCTGCACCCAAACCACCCTCAG	27	25	11	10	16	er	independent
seq1224_all_clean_seqs_gap0_no20_0.4	GCACGGCGGAATTTCAAATGGGGTTTTGTGGTTTCT	29	27	8	7	21	er	independent
seq1225_all_clean_seqs_gap0_no20_0.4	AGGTTCGTGGCAGGAAAGTTTGTGGCAGCAAAGCCT	23	21	13	12	10	er	independent
seq1228_all_clean_seqs_gap0_no20_0.4	CGTCTAATTGCAGGAAGTGGTTTGAAATGTTAATCT	18	16	13	12	5	er	cooperative
seq1229_all_clean_seqs_gap0_no20_0.4	GTGGGTTTAGGATATGGGTGTGGTTTCTAATTGTCT	21	19	10	9	11	er	independent
seq122_all_clean_seqs_gap0_no20_0.4	GGTCCCCCCGGTTCCGGCGCGGTTGAGGCCTTCGGT	20	18	13	11	7	er	cooperative
seq1230_all_clean_seqs_gap0_no20_0.4	AGACAGGAGTTCAGGAAGCTGCGGTCTAGATTATGT	22	20	14	13	8	er	cooperative
seq1231_all_clean_seqs_gap0_no20_0.4	GACACGTCTTTGGAAGGATGTGGTTGCCGTGGGTTT	21	19	16	15	5	er	cooperative
seq1232_all_clean_seqs_gap0_no20_0.4	GTTGAAATTGAGCTTCCGTTGGTGGTTAACCCTCTG	23	21	15	13	8	er	cooperative
seq1234_all_clean_seqs_gap0_no20_0.4	AAAGAACTTCCTGAGGTGCTTGAGGTTAGGCTATGG	23	21	9	7	14	er	cooperative
seq1235_all_clean_seqs_gap0_no20_0.4	TAAATGTTTCCTAAAAGCTCTTTCATAAACCACAGT	30	28	9	7	21	er	independent
seq1236_all_clean_seqs_gap0_no20_0.4	AGTTACAGTAAAGGATGTGGTGAAACAGATGTTTAT	18	16	13	12	5	er	cooperative
seq1239_all_clean_seqs_gap0_no20_0.4	CATCAAGTATTTCCTCACGCAAGCAACCGCATCCAT	27	25	12	10	15	er	independent
seq123_all_clean_seqs_gap0_no20_0.4	CCCGCGACACAAGGCGGATGTGGTACCCTCACTTGT	21	19	16	15	5	er	cooperative
seq1241_all_clean_seqs_gap0_no20_0.4	GTCTTCCTTCCTGAGAATCTTAACCACCAGCTTGCC	24	22	9	7	15	er	cooperative
seq1246_all_clean_seqs_gap0_no20_0.4	GCCACACTGGCGGAAATGGTGGTTACTGTTCGAGCC	20	18	12	11	8	er	cooperative
seq1247_all_clean_seqs_gap0_no20_0.4	TGGGGAACGCTGCGGATGCTGCGGTAAACCATGCGA	22	20	14	13	8	er	cooperative
seq1248_all_clean_seqs_gap0_no20_0.4	ATCTCCACATCCTCCCCATCGACCGCATGGTTTACC	23	21	10	8	13	er	cooperative
seq1249_all_clean_seqs_gap0_no20_0.4	GCAGTCAGAAGGTGCGGATGCGGTAAGGTATGCGCT	21	19	16	15	5	er	cooperative
seq1250_all_clean_seqs_gap0_no20_0.4	AACTTCCGAGGGAACTAACTGGTTTTAACCACATTG	29	27	5	3	24	er	cooperative
seq1251_all_clean_seqs_gap0_no20_0.4	TTCAACAGGATATTGCTTTGTTACCACAGGCCCTTT	24	22	8	7	16	er	cooperative
seq1253_all_clean_seqs_gap0_no20_0.4	CCTCCCTGAGGGGGAAGTGGTTTTTGAGTCTGAGTC	18	16	13	12	5	er	independent
seq1255_all_clean_seqs_gap0_no20_0.4	AGAAGCTTCTACAGGAAACCACTAATGGAGACAGAG	19	17	14	13	5	er	cooperative
seq1256_all_clean_seqs_gap0_no20_0.4	GTTTCTCTGGCCAGGAAATTGAGGTTTCTGTTAGTC	22	20	14	13	8	er	cooperative
seq1257_all_clean_seqs_gap0_no20_0.4	TGACTTCCTCCTCTTCACTAACAGAAACCTCAATTT	28	26	6	4	22	er	cooperative
seq1259_all_clean_seqs_gap0_no20_0.4	GGGGCTGGGAAAGGATGTGGTAAGGGCCAGTCAGTC	18	16	13	12	5	er	cooperative
seq1260_all_clean_seqs_gap0_no20_0.4	GGGACAGACTCTCCAGGATGTGGTTGGATTTTGGGC	21	19	16	15	5	er	cooperative
seq1261_all_clean_seqs_gap0_no20_0.4	AGAAGCTGCAGTCCCGGAAGCGGTTTTAGGGGGCCG	21	19	16	15	5	er	cooperative
seq1318_all_clean_seqs_gap0_no20_0.4	AGAAGCTGCAGTCCCGGAAGCGGTTTTAGGGGGCCG	21	19	16	15	5	er	cooperative
seq1264_all_clean_seqs_gap0_no20_0.4	GAAAACTAAGCAGGATGTGGTCTCGGCTGGAGCCTG	18	16	13	12	5	er	cooperative
seq1268_all_clean_seqs_gap0_no20_0.4	ACCTGTAGGCGGAAGTCTGTGGCTTTATTTACACAG	20	18	11	10	9	er	cooperative
seq790_all_clean_seqs_gap0_no20_0.4	ACCTGTAGGCGGAAGTCTGTGGCTTTATTTACACAG	20	18	11	10	9	er	cooperative
seq1269_all_clean_seqs_gap0_no20_0.4	AGCCACGGACTTCCGCCTACAGGTCGCCGCAGGTCC	27	25	12	10	15	er	cooperative
seq791_all_clean_seqs_gap0_no20_0.4	AGCCACGGACTTCCGCCTACAGGTCGCCGCAGGTCC	27	25	12	10	15	er	cooperative
seq1270_all_clean_seqs_gap0_no20_0.4	CCGCCCCCGGACGGTCACAGCACCCAAACCGCAGGC	29	27	9	8	20	er	independent
seq1271_all_clean_seqs_gap0_no20_0.4	GTGGGAGCGGAAGCCTGAGCGGCCTGCGGCCTCCGG	27	25	9	8	18	er	independent
seq796_all_clean_seqs_gap0_no20_0.4	GTGGGAGCGGAAGCCTGAGCGGCCTGCGGCCTCCGG	27	25	9	8	18	er	cooperative
seq1275_all_clean_seqs_gap0_no20_0.4	GTCCTCCACTATTGTTTCCGGCCGCAGCAGAGGCGG	22	20	17	15	5	er	cooperative
seq2153_all_clean_seqs_gap0_no20_0.4	GTCCTCCACTATTGTTTCCGGCCGCAGCAGAGGCGG	22	20	17	15	5	er	cooperative
seq2227_all_clean_seqs_gap0_no20_0.4	AAAGTAGGTCCGGTCCGCGGGTGCGGTCGGGCATGC	24	22	9	7	15	er	independent
seq1279_all_clean_seqs_gap0_no20_0.4	GATTGTTATGTCCGGAAACCGCTTATCAGAGCCCTG	19	17	14	13	5	er	cooperative
seq839_all_clean_seqs_gap0_no20_0.4	GATTGTTATGTCCGGAAACCGCTTATCAGAGCCCTG	19	17	14	13	5	er	cooperative
seq1280_all_clean_seqs_gap0_no20_0.4	CGGGACCTGTTTCCTTGGGAACCACAAGATAAGACC	22	20	12	10	10	er	independent
seq1282_all_clean_seqs_gap0_no20_0.4	GCCCACCCGCTTCCGGTTGTGGGCCCCGCCCGCCGA	20	18	12	10	8	er	cooperative
seq860_all_clean_seqs_gap0_no20_0.4	GCCCACCCGCTTCCGGTTGTGGGCCCCGCCCGCCGA	20	18	12	10	8	er	cooperative
seq1283_all_clean_seqs_gap0_no20_0.4	AAAGACAGGATGTGGGGGAGTGAGCCACAAGGGCCC	25	23	8	7	17	er	cooperative
seq2293_all_clean_seqs_gap0_no20_0.4	AAAGACAGGATGTGGGGGAGTGAGCCACAAGGGCCC	25	23	8	7	17	er	cooperative
seq1286_all_clean_seqs_gap0_no20_0.4	GATATGGCAGGAAGTAGGGCCTGGAAACCGCACGGC	28	26	10	9	18	er	cooperative
seq894_all_clean_seqs_gap0_no20_0.4	GATATGGCAGGAAGTAGGGCCTGGAAACCGCACGGC	28	26	10	9	18	er	cooperative
seq1291_all_clean_seqs_gap0_no20_0.4	GACAATGAGCGCACAGGATGTGGTTTGGCGGCAGGG	21	19	16	15	5	er	cooperative
seq2530_all_clean_seqs_gap0_no20_0.4	GACAATGAGCGCACAGGATGTGGTTTGGCGGCAGGG	21	19	16	15	5	er	cooperative
seq1293_all_clean_seqs_gap0_no20_0.4	GGCTGCGACTTCCGGACTGCTCCTGGCCGCAGGGGG	27	25	11	9	16	er	cooperative
seq2559_all_clean_seqs_gap0_no20_0.4	GGCTGCGACTTCCGGACTGCTCCTGGCCGCAGGGGG	27	25	11	9	16	er	cooperative
seq1294_all_clean_seqs_gap0_no20_0.4	CAGTGGCTAAGGATCCGGTGTTGCGGTGATACATGA	24	22	14	12	10	er	cooperative
seq960_all_clean_seqs_gap0_no20_0.4	CAGTGGCTAAGGATCCGGTGTTGCGGTGATACATGA	24	22	14	12	10	er	cooperative
seq1295_all_clean_seqs_gap0_no20_0.4	AAACATCATAGGAAGTGGATTTTGTGGTGAGAGACA	25	23	11	10	14	er	ambiguous
seq2731_all_clean_seqs_gap0_no20_0.4	AAACATCATAGGAAGTGGATTTTGTGGTGAGAGACA	25	23	11	10	14	er	cooperative
seq1297_all_clean_seqs_gap0_no20_0.4	AACCCCAAAACGGAAACACCGGAGCCACAAGCTGAG	25	23	12	11	13	er	cooperative
seq2815_all_clean_seqs_gap0_no20_0.4	AACCCCAAAACGGAAACACCGGAGCCACAAGCTGAG	25	23	12	11	13	er	cooperative
seq1301_all_clean_seqs_gap0_no20_0.4	GGTCTCACCGCTCTTCCGCTTGCGGTTTCGGGGGCC	23	21	15	13	8	er	cooperative
seq1304_all_clean_seqs_gap0_no20_0.4	GTGGCGGGGCGGAAGTTCACATGTGTGGTATGTAGA	26	24	11	10	15	er	cooperative
seq2991_all_clean_seqs_gap0_no20_0.4	GTGGCGGGGCGGAAGTTCACATGTGTGGTATGTAGA	26	24	11	10	15	er	cooperative
seq1309_all_clean_seqs_gap0_no20_0.4	TGAAGTTGGTGTTTTCCGGGGGCGGTTTTTCCATTG	23	21	15	13	8	er	independent
seq1314_all_clean_seqs_gap0_no20_0.4	TAAGCAGGGAATAGAGGAAGTGGTTTTGTCTCAGGC	21	19	16	15	5	er	cooperative
seq3095_all_clean_seqs_gap0_no20_0.4	TAAGCAGGGAATAGAGGAAGTGGTTTTGTCTCAGGC	21	19	16	15	5	er	cooperative
seq1323_all_clean_seqs_gap0_no20_0.4	GGGGGAGTTTTCGGAAGCGCTAACCGCGTTGGGGCC	24	22	13	12	11	er	independent
seq1324_all_clean_seqs_gap0_no20_0.4	AATCGCGCAGTTCCGCAGCTGCCGCCCCACAACCGT	27	25	12	10	15	er	independent
seq1326_all_clean_seqs_gap0_no20_0.4	AAACAGGAAATCACAGCAGCGTTGCGGAGTGGAGCA	25	23	6	5	19	er	cooperative
seq1329_all_clean_seqs_gap0_no20_0.4	CACTTCCCCCAGCCTCTCTTTTTAATACCACAATAG	28	26	5	3	23	er	independent
seq1330_all_clean_seqs_gap0_no20_0.4	TACCTACAGGAAATGAGACACACCGCAGGCCGATCC	23	21	9	8	14	er	cooperative
seq1331_all_clean_seqs_gap0_no20_0.4	TGTCTCATTTCCTGTAGGTAACAGGCACCACAATAG	28	26	10	8	18	er	cooperative
seq1334_all_clean_seqs_gap0_no20_0.4	AGACCCGGAAGAACTTGTCCCAGTGTTGACCACACC	30	28	7	6	23	er	ambiguous
seq1335_all_clean_seqs_gap0_no20_0.4	TGCTTCCCTTCCGTTCCGACAGCGAAAACCGCTGCC	29	27	10	8	19	er	cooperative
seq1337_all_clean_seqs_gap0_no20_0.4	CAAGCACATTACGGAAGAGGCTGACCGCAAATACGA	25	23	13	12	12	er	independent
seq1338_all_clean_seqs_gap0_no20_0.4	TTGGTCAGGATGTGGCTGAAGAAGCCACAAGAAAAA	25	23	8	7	17	er	cooperative
seq1341_all_clean_seqs_gap0_no20_0.4	GAAGTGTGCTCTTCCGGTACCTGCGGTTCGTTGCGC	24	22	13	11	11	er	cooperative
seq1343_all_clean_seqs_gap0_no20_0.4	GCACTCGGATGTTGGCCGTAGTTGTGGTTATAGTTG	25	23	7	6	18	er	ambiguous
seq1344_all_clean_seqs_gap0_no20_0.4	TACCTACATCCTGCCACCACCCGAGGGGACCGCAAG	30	28	9	7	21	er	cooperative
seq1345_all_clean_seqs_gap0_no20_0.4	TGGCAGAGCACATCCTGTGCGGTTTTCAGTTTTGCT	20	18	13	11	7	er	cooperative
seq1349_all_clean_seqs_gap0_no20_0.4	CTGTCCGCTACATCCGGGACCTGCGGGACCGCCGAT	24	22	13	11	11	er	cooperative
seq1350_all_clean_seqs_gap0_no20_0.4	TTACTTCCTGAGGGTGCACAGGCTGTGGTCGTCTAT	26	24	6	4	20	er	cooperative
seq1353_all_clean_seqs_gap0_no20_0.4	TCGTGAAAAAGGAAGTGGATAAAGTGGTTACGGCAA	25	23	11	10	14	er	cooperative
seq1354_all_clean_seqs_gap0_no20_0.4	AGGCCGCCTACAGGATGTTGGAAACCACAGGGCCCG	25	23	13	12	12	er	cooperative
seq1357_all_clean_seqs_gap0_no20_0.4	AACAAACCGGATGGGGTTGCCACCCGCAATCTTGTC	24	22	9	8	15	er	cooperative
seq1358_all_clean_seqs_gap0_no20_0.4	CGGGTTGGGCAGGAAGCAGCATGACCGCAGTGGGTC	25	23	12	11	13	er	cooperative
seq1359_all_clean_seqs_gap0_no20_0.4	GCTCCCGGATGTTCTGGGGATCTGCGGCCGCCTGGC	25	23	7	6	18	er	cooperative
seq135_all_clean_seqs_gap0_no20_0.4	GGGGCAGCTTCCGGCAGGAGAGCCCGCATTCCCGGC	24	22	10	8	14	er	cooperative
seq1361_all_clean_seqs_gap0_no20_0.4	AAAGAGGAAATCACGTACCCGAAAACCACATGCACA	26	24	6	5	20	er	independent
seq1362_all_clean_seqs_gap0_no20_0.4	TACTAGTTTGGGGCATCCTGTGGTATAGGGGAAGCA	21	19	16	14	5	er	cooperative
seq1364_all_clean_seqs_gap0_no20_0.4	AAGACAACATCCTGCCGGCACAGCCTGCGGGTTACT	28	26	10	8	18	er	cooperative
seq1365_all_clean_seqs_gap0_no20_0.4	CCTGGGGGGCCGGAAGCCCCGCTGCGGCCCCAGCCC	25	23	12	11	13	er	cooperative
seq1366_all_clean_seqs_gap0_no20_0.4	CACCCTCAACTTCCTGACCCATAAACCACAAGCTAT	26	24	12	10	14	er	independent
seq1367_all_clean_seqs_gap0_no20_0.4	GACCACTTCCTTTCTGTGTTTTGTGGTTTCACAACT	24	22	8	6	16	er	cooperative
seq1368_all_clean_seqs_gap0_no20_0.4	GCAGCATTTCCTGACTTCTTCGCCCCTGTGGTTGCA	29	27	9	7	20	er	cooperative
seq1369_all_clean_seqs_gap0_no20_0.4	GGGATCCTTCCGCTCCGGGTTAACCCCGACCGCGCC	30	28	9	7	21	er	cooperative
seq136_all_clean_seqs_gap0_no20_0.4	GTAAACTAGCTCTTCCGGTCTGTGGCCCTCACAGGA	23	21	14	12	9	er	cooperative
seq1376_all_clean_seqs_gap0_no20_0.4	GCAGTGCAGGAAGTGCTTTGTGTGGTACAATCCCAA	23	21	9	8	14	er	cooperative
seq1377_all_clean_seqs_gap0_no20_0.4	CCAGAGCACATCCTACACGCACCACAACCTGAAAAC	22	20	11	9	11	er	independent
seq137_all_clean_seqs_gap0_no20_0.4	AGGCGCCGGAAAAACTACATCTCCCACAATCCTCGG	24	22	8	7	16	er	independent
seq1380_all_clean_seqs_gap0_no20_0.4	TTTACTGAGAGGAAGTGGTTCTTGTGGGTGAAGGTC	25	23	11	10	14	er	cooperative
seq1381_all_clean_seqs_gap0_no20_0.4	GGTCTCTGCTTCCGGTCCTTGTGGTAGCACCTCTGT	22	20	11	9	11	er	cooperative
seq1383_all_clean_seqs_gap0_no20_0.4	CACCTCCTACTTCCCCCCGCTGATAACCACCAACCC	27	25	12	10	15	er	independent
seq1384_all_clean_seqs_gap0_no20_0.4	GAGCAGGAAGCACCCCCAGCACAGGCCTGCGGTGAG	30	28	6	5	24	er	cooperative
seq1385_all_clean_seqs_gap0_no20_0.4	CTCACTCATCTGACTTCCTGCGGTTTACGACAACAG	21	19	16	14	5	er	ambiguous
seq1387_all_clean_seqs_gap0_no20_0.4	AAAACAACTCCAGGATGTGGTTTTACTCAGAATGTA	18	16	13	12	5	er	cooperative
seq1390_all_clean_seqs_gap0_no20_0.4	TTTTTTCCGCCTGTAGGGTCACATTGTGGTTGATTG	27	25	6	4	21	er	cooperative
seq1392_all_clean_seqs_gap0_no20_0.4	TCCGGAAGTCGGAGGAACACCCCAGCCGCCGCAGCC	29	27	4	3	25	er	cooperative
seq1394_all_clean_seqs_gap0_no20_0.4	GGCTGTGCTTCAGGATGTGGTAATGCTTGGGAGGCG	18	16	13	12	5	er	cooperative
seq1395_all_clean_seqs_gap0_no20_0.4	CTCTTTCACAAAGGAAATGGAAACCACAAAGAGGAC	24	22	13	12	11	er	cooperative
seq1397_all_clean_seqs_gap0_no20_0.4	TGGCAGCGGGTGCGGAAACCACAGGCCTCCAGGCTT	19	17	14	13	5	er	cooperative
seq1398_all_clean_seqs_gap0_no20_0.4	AGGGAACAGGAAATGCAAAAAACCACAAGGGACAAG	23	21	9	8	14	er	cooperative
seq1399_all_clean_seqs_gap0_no20_0.4	GACCAATGTAAACAAGGATGTGGGTTCTCCGGGCAC	21	19	16	15	5	er	cooperative
seq13_all_clean_seqs_gap0_no20_0.4	GAGGACTTCCGGGTGGGTGTGATATCTGCGGGCCCG	29	27	8	6	21	er	cooperative
seq1401_all_clean_seqs_gap0_no20_0.4	GCGCTACAGGAACTTCCTGCGCGGTTGCTGTCGTTG	22	20	15	13	7	er	cooperative
seq1402_all_clean_seqs_gap0_no20_0.4	GCGCAAGGATCCGGTTTGTTGTGGTGTGGGGAGGGG	22	20	10	8	12	er	independent
seq1403_all_clean_seqs_gap0_no20_0.4	ACCAGAAGCACTGCAGGATGTGGTATCAAGACGCCT	21	19	16	15	5	er	cooperative
seq1404_all_clean_seqs_gap0_no20_0.4	TATTCAGGCTTCCGGGTGATGTTTGTGGCCACCCGG	26	24	11	9	15	er	cooperative
seq1405_all_clean_seqs_gap0_no20_0.4	CACTTCCTCTGTGACTGCAGGTTTCCAACCACAAGC	29	27	5	3	24	er	cooperative
seq1406_all_clean_seqs_gap0_no20_0.4	GCATCATCACTTCCTGTTGTGGGCAGTCGTTGCCTG	20	18	12	10	8	er	cooperative
seq1408_all_clean_seqs_gap0_no20_0.4	TTGTCACGTCCGGCACGCCGCGAACCGCAAGGAACC	25	23	9	7	16	er	cooperative
seq1409_all_clean_seqs_gap0_no20_0.4	TCCTATATACTTCCGTTTGCCTCGCGGTTTCTTTCT	25	23	12	10	13	er	cooperative
seq1410_all_clean_seqs_gap0_no20_0.4	GTTCTTCCACGTCCGCGTTACCCACAACGGCAGTGG	22	20	12	10	10	er	ambiguous
seq1411_all_clean_seqs_gap0_no20_0.4	TCTTCTTCCTCCCCCACCCCAAAAGCCACAGGTGAC	26	24	7	5	19	er	independent
seq1412_all_clean_seqs_gap0_no20_0.4	CCCTCTCTTCTTCCTCCCCCACCACAAAAGTCACAG	22	20	12	10	10	er	independent
seq1413_all_clean_seqs_gap0_no20_0.4	CCCCCTGAACATCCGGGGCCTTTTAACCGCCCACGG	27	25	12	10	15	er	cooperative
seq1415_all_clean_seqs_gap0_no20_0.4	GCGCGGACAGAGAAAGGATGTGGTATAGCAGAAAGT	21	19	16	15	5	er	cooperative
seq1416_all_clean_seqs_gap0_no20_0.4	GGCCGGCTTCCGGGGCGGGTGGAAAGGAGCCACAAG	30	28	9	7	21	er	cooperative
seq1417_all_clean_seqs_gap0_no20_0.4	CAGGCTCGCCACAGGGGAAGTGGTTAGGGCGGGTCC	21	19	16	15	5	er	cooperative
seq1418_all_clean_seqs_gap0_no20_0.4	CGACCGGAACCACTCTGAGGCGCTGCCGCAGACACC	26	24	6	5	20	er	ambiguous
seq1419_all_clean_seqs_gap0_no20_0.4	AGGCCCGGATACCCGCCCCCAAAACCGCGTCCACAA	25	23	7	6	18	er	independent
seq1420_all_clean_seqs_gap0_no20_0.4	GTTGGGAGGCGCACATCCGGCGGTTACCCGGTGCTT	21	19	16	14	5	er	cooperative
seq1421_all_clean_seqs_gap0_no20_0.4	GTGCCTCACCGCTTCCGGCGCTGCGGGATGACGTCA	24	22	14	12	10	er	cooperative
seq1423_all_clean_seqs_gap0_no20_0.4	GCGCCAGTCACCGTTTCCTGTGGTTTGCTGCCCGCC	21	19	16	14	5	er	cooperative
seq1424_all_clean_seqs_gap0_no20_0.4	TTATTTCCGGTGTTGATCTTTTTAGTGGTACCAGGC	26	24	6	4	20	er	cooperative
seq1425_all_clean_seqs_gap0_no20_0.4	TAGGCGGAAAGCCCGCTAGCCTAAACCACAGAGGGT	26	24	6	5	20	er	independent
seq1426_all_clean_seqs_gap0_no20_0.4	CCTCTTGCTGCCTCTTCCTGTGGTCTTTTCTCTGTC	21	19	16	14	5	er	independent
seq1427_all_clean_seqs_gap0_no20_0.4	CTCTGCTTCCTGTCTTTGAATGCCTCTGTGGTTTTC	29	27	8	6	21	er	cooperative
seq1429_all_clean_seqs_gap0_no20_0.4	CTACAGGAAGTTCGAACTGGGCGGAGCCCACCGCAG	31	29	6	5	25	er	cooperative
seq1430_all_clean_seqs_gap0_no20_0.4	CCGGGACAGGAAGAGGCTGGGGACCGCGGCGAAGGT	24	22	9	8	15	er	cooperative
seq1431_all_clean_seqs_gap0_no20_0.4	CCACGGCTGGCTTCCTGTGTGGTTGGCACGCCTTAC	20	18	13	11	7	er	cooperative
seq1432_all_clean_seqs_gap0_no20_0.4	TGCTTTTCAGGTGCAGGAAGTGGTTTGCCTTTGCCC	21	19	16	15	5	er	cooperative
seq1433_all_clean_seqs_gap0_no20_0.4	TCACCTCATCACAGGAAACCGCGAGCACCTCCTCCT	19	17	14	13	5	er	ambiguous
seq1434_all_clean_seqs_gap0_no20_0.4	CCACCCACTTCCTGCCCTAGCTAGTGTGGTATTTTT	27	25	10	8	17	er	cooperative
seq1435_all_clean_seqs_gap0_no20_0.4	GTTTTCAAGGCAGGAAGTGGCTGTGGTGGCACGGAG	24	22	13	12	11	er	cooperative
seq1436_all_clean_seqs_gap0_no20_0.4	GCGGCTGAGAACACAGGATGTGGCTTTTGGCAGATG	21	19	16	15	5	er	cooperative
seq1437_all_clean_seqs_gap0_no20_0.4	CATGACGAAGGGGAAGGATGTGGTTTGAGGGCAGCA	21	19	16	15	5	er	cooperative
seq1438_all_clean_seqs_gap0_no20_0.4	CTCCGATTGAGAACAGGAAGCCACAGGCCAATACAA	21	19	16	15	5	er	cooperative
seq1439_all_clean_seqs_gap0_no20_0.4	TTTAGACACCGCTTCCTGCCACAAGCCCAAGACTTA	19	17	14	12	5	er	cooperative
seq143_all_clean_seqs_gap0_no20_0.4	CCGGGCTGCGGAAGGCGGGAACTCTGCGGTTCGCGG	27	25	10	9	17	er	independent
seq333_all_clean_seqs_gap0_no20_0.4	CCGGGCTGCGGAAGGCGGGAACTCTGCGGTTCGCGG	27	25	10	9	17	er	independent
seq1440_all_clean_seqs_gap0_no20_0.4	GATCCCCCTCCTCCATCCTGTGGCTTCGGGTTGCCG	21	19	16	14	5	er	cooperative
seq1441_all_clean_seqs_gap0_no20_0.4	AGTGGATAGCACTTCCTTCTCTTACCACAGTTCCTT	25	23	14	12	11	er	cooperative
seq1442_all_clean_seqs_gap0_no20_0.4	GGCTTCCGGCGGGGTACCCTCCTCTGTGGGCGGGGC	27	25	5	3	22	er	cooperative
seq1443_all_clean_seqs_gap0_no20_0.4	TACCCCGCCGGAAGCCCCCTGCTCTGTGGGAACCGG	27	25	10	9	17	er	cooperative
seq1444_all_clean_seqs_gap0_no20_0.4	GAGAGAGGCAGGAAGTGTTGTGGTTATTGTTTGAGC	21	19	11	10	10	er	cooperative
seq1445_all_clean_seqs_gap0_no20_0.4	AGTCTAACCAACAAAGGATGTGGTAGGTAAAAGGTT	21	19	16	15	5	er	cooperative
seq1446_all_clean_seqs_gap0_no20_0.4	ATACCGGCGCATCCGGATTTTGAAGCCGCAGTGGAC	26	24	12	10	14	er	cooperative
seq1447_all_clean_seqs_gap0_no20_0.4	CTCACAGAAGAGGCAGGAAGTGGTTTGAGTTATCAT	21	19	16	15	5	er	cooperative
seq1448_all_clean_seqs_gap0_no20_0.4	CTCATTGACAGGAAGTCTAACCACAGGCTTAGGCCC	21	19	11	10	10	er	cooperative
seq1449_all_clean_seqs_gap0_no20_0.4	CACCCCCCCAGTGCAGGAAGTGGTTTTCGAGGGCAG	21	19	16	15	5	er	cooperative
seq1450_all_clean_seqs_gap0_no20_0.4	TGCAATCAGGAAGCCTGCCCCTCTAGAACCACAAAA	29	27	9	8	20	er	independent
seq1451_all_clean_seqs_gap0_no20_0.4	CTGCTGCCGCGAACAGGAAACCACTACAATCAGGAG	21	19	16	15	5	er	cooperative
seq1454_all_clean_seqs_gap0_no20_0.4	AGCAACAGGAAAGAACAGCCTGACCACAGCAGCCAC	24	22	8	7	16	er	independent
seq1455_all_clean_seqs_gap0_no20_0.4	CAGCTGACAGGAAGGAGAGAACCACAGACAGTGCGA	22	20	10	9	12	er	cooperative
seq1456_all_clean_seqs_gap0_no20_0.4	TCCCTAAGTCACATCCTGTGGGCAAAGGCCCTAGCA	19	17	14	12	5	er	cooperative
seq1457_all_clean_seqs_gap0_no20_0.4	GCAGAACCAGAAACAGGATGTGGGTTCCCCTTTAAG	21	19	16	15	5	er	cooperative
seq1458_all_clean_seqs_gap0_no20_0.4	TTTGAGCGGGCAGGATGTGGTGACAATGATACTGCA	18	16	13	12	5	er	cooperative
seq1459_all_clean_seqs_gap0_no20_0.4	CCTGCAGCAACAGGATGTGGTTTGAAAGGATGAAAG	18	16	13	12	5	er	cooperative
seq1460_all_clean_seqs_gap0_no20_0.4	GGAACAGGAAGCGGCAGAAATAGCAGCCACCGCGGC	30	28	7	6	23	er	cooperative
seq1461_all_clean_seqs_gap0_no20_0.4	CTCGTGCGTCACTTCCGCCCCGCAGACCCGCCCACT	20	18	14	12	6	er	cooperative
seq1462_all_clean_seqs_gap0_no20_0.4	CAGGCTGCTTCCGGCGCGCGGCAGAGCGGTCAGAGC	27	25	10	8	17	er	cooperative
seq1465_all_clean_seqs_gap0_no20_0.4	GCAGGGACCGGAAGTCCATGGCTCTGCCGCAACCCT	27	25	10	9	17	er	cooperative
seq1466_all_clean_seqs_gap0_no20_0.4	GAGCTGCTCCGGAAGGGTGGTGTGTGGTCAACCTTG	25	23	11	10	14	er	ambiguous
seq1467_all_clean_seqs_gap0_no20_0.4	GCACTGTGGGAGGAAGTGGGTATGTGGTGAGCTCTT	25	23	12	11	13	er	cooperative
seq1468_all_clean_seqs_gap0_no20_0.4	GACCTGCCTTCCGGCCTCCGTCACATGACCGCACAG	29	27	10	8	19	er	cooperative
seq1469_all_clean_seqs_gap0_no20_0.4	CATAGACCGGATGCCTCGTCAACCACAGAAACCAAT	23	21	9	8	14	er	cooperative
seq146_all_clean_seqs_gap0_no20_0.4	ACGTACGGGATGTGGGAGGTTTGTTTTGACCACACC	30	28	8	7	22	er	cooperative
seq1470_all_clean_seqs_gap0_no20_0.4	TTTTGCCCAACAGGATGTGGTTTCTAAAGCAGACGG	18	16	13	12	5	er	cooperative
seq1473_all_clean_seqs_gap0_no20_0.4	GCTCCCTGGACAGGATGTGGTGCCGAGTAAACAGCT	18	16	13	12	5	er	cooperative
seq1474_all_clean_seqs_gap0_no20_0.4	GCCGGGCACTTCCTGTGGAGGCCGCAGCGGGTGCGC	22	20	11	9	11	er	cooperative
seq1475_all_clean_seqs_gap0_no20_0.4	CTCACCCCTGGAGGATGTGGGTTTCCAGGCTGACAG	18	16	13	12	5	er	cooperative
seq1477_all_clean_seqs_gap0_no20_0.4	GCAGGACTTCCTGTGTTGTGCTAACCTCAAATTACA	25	23	9	7	16	er	cooperative
seq1481_all_clean_seqs_gap0_no20_0.4	GCCCCCATGCTTCCTGTTGTGGGAGATGAAGTGTGG	20	18	12	10	8	er	cooperative
seq1482_all_clean_seqs_gap0_no20_0.4	ACACACTGACTTCCTGTTGTGGGAGATAAAGTGTGG	20	18	12	10	8	er	cooperative
seq1483_all_clean_seqs_gap0_no20_0.4	CCCTTCCGCGTGGGTTGCACCTGCTAACCACAGAGC	28	26	5	3	23	er	cooperative
seq1486_all_clean_seqs_gap0_no20_0.4	AATCCCGGAAACGCGGATTCAGCGGAGCGCGGTGAC	30	28	7	6	23	er	cooperative
seq1487_all_clean_seqs_gap0_no20_0.4	GAGGCCGAAAGGAAGTTTGAGGTTAAGCACAAGATG	20	18	11	10	9	er	cooperative
seq1488_all_clean_seqs_gap0_no20_0.4	CCTGCTGCTTCCGCCCGGAGTTGTTGTGGGCTCCAG	27	25	10	8	17	er	cooperative
seq1489_all_clean_seqs_gap0_no20_0.4	AGCTTGCTTCCTGTCCCCAAAACCCACAGCACACGG	24	22	9	7	15	er	cooperative
seq1491_all_clean_seqs_gap0_no20_0.4	GGCTGCAGGAAGTGGGAAGGTGTGGCTTTGAGTCTC	23	21	8	7	15	er	cooperative
seq1492_all_clean_seqs_gap0_no20_0.4	GGTGGCCGCCGGAAGTGTGACCGCGGGAGGGGAGTG	21	19	11	10	10	er	cooperative
seq1493_all_clean_seqs_gap0_no20_0.4	CCGCCGACACACTTCCGGCGGCCACCACAGGGTATT	25	23	14	12	11	er	cooperative
seq1495_all_clean_seqs_gap0_no20_0.4	GCCGCTGCCTCTTCCTGTGTGGTTTTTCAGGGCTTA	20	18	13	11	7	er	cooperative
seq1496_all_clean_seqs_gap0_no20_0.4	CTTAGAGTACCAGGATGTGGTTTGGCCTGGGGGTGG	18	16	13	12	5	er	cooperative
seq1498_all_clean_seqs_gap0_no20_0.4	TTTCTGACTTCCTGTGTGCTTCAGAAACCTCAATGA	28	26	10	8	18	er	cooperative
seq1499_all_clean_seqs_gap0_no20_0.4	GAAAGGGTTCATCCAGGAAACCACAACCCAGTGCCG	21	19	16	15	5	er	independent
seq149_all_clean_seqs_gap0_no20_0.4	GCAGGCGGAGCTTGAGGAAACCGCAGATAAGTTTTT	21	19	16	15	5	er	independent
seq1501_all_clean_seqs_gap0_no20_0.4	CTGCCCAGCCACTTCCTGCCCAACCACAGACTGACA	24	22	14	12	10	er	cooperative
seq1502_all_clean_seqs_gap0_no20_0.4	CAGCAGAGGCGCGGATGTGGTTAAACGAGTGCCGTC	18	16	13	12	5	er	cooperative
seq1503_all_clean_seqs_gap0_no20_0.4	GAAAAATGAAGTTTCCGCAGTAACCACAACACAGCC	24	22	14	12	10	er	cooperative
seq1504_all_clean_seqs_gap0_no20_0.4	GGCCTGTCACACACAGGAAGCGGTCACAGAAAAGCT	21	19	16	15	5	er	cooperative
seq1505_all_clean_seqs_gap0_no20_0.4	CAACTTCCGGGGCCGGTTGCCTGGCAACCGCAGGAG	28	26	6	4	22	er	cooperative
seq1506_all_clean_seqs_gap0_no20_0.4	GGCAACCGGCCCCGGAAGTTGCGGCAGGTGCGTCCA	22	20	14	13	8	er	cooperative
seq1507_all_clean_seqs_gap0_no20_0.4	GAGGTGCCGGAAGCCAGTAGGTGGTTTTGGGTGCTA	22	20	9	8	13	er	cooperative
seq1508_all_clean_seqs_gap0_no20_0.4	TGATGCACTTCCTGAGGGCCCGCATGTGGTAAACAC	27	25	10	8	17	er	cooperative
seq1509_all_clean_seqs_gap0_no20_0.4	ACACAGAGAGTGAGAGGAAGTGGTTTAGAGATGAGA	21	19	16	15	5	er	cooperative
seq1510_all_clean_seqs_gap0_no20_0.4	CCTCAAAACCCGGAAACGCCTTGCGGGGCAGTGTGG	24	22	12	11	12	er	cooperative
seq1511_all_clean_seqs_gap0_no20_0.4	CCGGCAGGAAGTTAGCATGGGCGGACCACACGGGGG	26	24	7	6	19	er	ambiguous
seq1512_all_clean_seqs_gap0_no20_0.4	AGGGACTTCCGGTGACCAGAGCACTAGCGCCGCAAA	30	28	8	6	22	er	cooperative
seq1514_all_clean_seqs_gap0_no20_0.4	GAGGGTTGCTGGGGGGAAGTGTGGTAAATCTTTTCC	22	20	15	14	7	er	independent
seq1519_all_clean_seqs_gap0_no20_0.4	AGCTGAAGGGCAGGATGTGGTTTCAGCATTCGGTGA	18	16	13	12	5	er	cooperative
seq1521_all_clean_seqs_gap0_no20_0.4	AATTGAGACAGGAAATGTTGGTTTGTGGTCAGGCAC	26	24	11	10	15	er	cooperative
seq1522_all_clean_seqs_gap0_no20_0.4	AGTAGAGGAGGAAGTTAAATGTGGTTTTCTGGGTGG	22	20	10	9	12	er	cooperative
seq1523_all_clean_seqs_gap0_no20_0.4	TCCAGCTCCACAGGATGTGGTGAGTGAAGCAGCAAG	18	16	13	12	5	er	cooperative
seq1525_all_clean_seqs_gap0_no20_0.4	GAAGTGAGGTCAGGATGTGGTGGGTGACCCCTGAAA	18	16	13	12	5	er	cooperative
seq1526_all_clean_seqs_gap0_no20_0.4	AGAAGCAGGCATGCAGGATGTGGTTAGTGCATGGTA	21	19	16	15	5	er	cooperative
seq1527_all_clean_seqs_gap0_no20_0.4	AACAGGAAGTGGTCTTAGAGATCATGCGGTTCAGAG	27	25	5	4	22	er	cooperative
seq1528_all_clean_seqs_gap0_no20_0.4	AGACTCCATCCGCCATGTTGGATGCCGCAGATTCGC	25	23	9	7	16	er	cooperative
seq1530_all_clean_seqs_gap0_no20_0.4	TCATTTCCTCTGGTGTTATTGTGTTGTGGTTTTAAG	27	25	6	4	21	er	cooperative
seq1531_all_clean_seqs_gap0_no20_0.4	ATACTGAGTCATTTCCTGTGGTGTTATTGTGTTGTA	19	17	14	12	5	er	cooperative
seq1533_all_clean_seqs_gap0_no20_0.4	GCCACCTCTTCCTGTGTTGCAAACCACAGGTCCACC	24	22	10	8	14	er	cooperative
seq1534_all_clean_seqs_gap0_no20_0.4	GCCGCCTCTTCCTGTGTTGCAAACCACAGGTCCACC	24	22	10	8	14	er	cooperative
seq1535_all_clean_seqs_gap0_no20_0.4	ATAGTCTCTTCCTGTGTTGCAAACCACAGGTCCACC	24	22	10	8	14	er	cooperative
seq1538_all_clean_seqs_gap0_no20_0.4	GCCCAGGGCGGCCGGAAGTTTGCGGGGCGGGGCGGA	23	21	14	13	9	er	cooperative
seq1539_all_clean_seqs_gap0_no20_0.4	CCCCTCCCTGCTTCCTGTGTGGTGAGGGGTGATCAG	20	18	13	11	7	er	cooperative
seq153_all_clean_seqs_gap0_no20_0.4	CAGAGCAGAGAGGAAGTGGTGGTGGCCACAGTCCCA	26	24	12	11	14	er	cooperative
seq1544_all_clean_seqs_gap0_no20_0.4	TGGAACAATGCTGCTTCCTGTGGGTGTCCCCCGGCC	21	19	16	14	5	er	cooperative
seq1546_all_clean_seqs_gap0_no20_0.4	ACACCCCAGGAAGTGGCAGAGACCACAACAAGTCAG	23	21	9	8	14	er	cooperative
seq1547_all_clean_seqs_gap0_no20_0.4	GTGGTCTCTGCCACTTCCTGTGGTGTAAACAGTCTC	21	19	16	14	5	er	cooperative
seq1548_all_clean_seqs_gap0_no20_0.4	ATGAACCACTTCCTGTGTGTTCCCACAGAGGTCAGG	23	21	11	9	12	er	cooperative
seq1549_all_clean_seqs_gap0_no20_0.4	AGGCCGTGCAGGAAATGAGACCCACAGCCACGTCAC	22	20	11	10	11	er	cooperative
seq1550_all_clean_seqs_gap0_no20_0.4	GAATGACAGAAGCGGAAACCACATGAAAAAGGTGTT	19	17	14	13	5	er	cooperative
seq1553_all_clean_seqs_gap0_no20_0.4	ACTGCACGGCTGGGAGGATGTGGTCACACACGCCAC	21	19	16	15	5	er	cooperative
seq1554_all_clean_seqs_gap0_no20_0.4	AGCGCCCCATCCCGCGGATGTGGTAAAGCTTCGCGC	21	19	16	15	5	er	cooperative
seq1556_all_clean_seqs_gap0_no20_0.4	GGGTCCTTCCGGGTTTTGTGTCGAATCTGCGGCGGC	30	28	8	6	22	er	cooperative
seq1557_all_clean_seqs_gap0_no20_0.4	TCAGGGGTGGGAGGAAGTGGTTAGGATCAGCCTGGG	18	16	13	12	5	er	cooperative
seq1558_all_clean_seqs_gap0_no20_0.4	CTGCAGATGCATTTCCTTTTTGTGGTAGCAAGCGTG	23	21	14	12	9	er	cooperative
seq1559_all_clean_seqs_gap0_no20_0.4	TGACAGACCCGGAAATAAGAGGAGACCACACACTTG	26	24	11	10	15	er	cooperative
seq1561_all_clean_seqs_gap0_no20_0.4	CCCACCCTCGCCGGAAGCCGAGCGGTTTCTACATCA	23	21	13	12	10	er	cooperative
seq1562_all_clean_seqs_gap0_no20_0.4	AGGACACAGACAGGAAACCCGCAGGCTTTGTTTTTT	19	17	13	12	6	er	cooperative
seq1563_all_clean_seqs_gap0_no20_0.4	AGGACCTAACACTCAGGAAGTGGTCAACCTTGCTGC	21	19	16	15	5	er	cooperative
seq1568_all_clean_seqs_gap0_no20_0.4	TGGCTTTGCAGAAGGAAGCTGTGGTTTCTGGTCTTC	22	20	14	13	8	er	independent
seq1569_all_clean_seqs_gap0_no20_0.4	TCTTTAAAACCCGGAAGTTCCTGTGGTTCATACGCT	24	22	13	12	11	er	cooperative
seq1570_all_clean_seqs_gap0_no20_0.4	GGTTTCCGGGTGAAAAAAAAAAAAAAAACCACGCCA	29	27	5	3	24	er	cooperative
seq1571_all_clean_seqs_gap0_no20_0.4	AAGACACCAACGCTCGGAAACCGCCAGACACCAACG	21	19	16	15	5	er	independent
seq1572_all_clean_seqs_gap0_no20_0.4	CAGACACCAACGCTCGGAAACCGCCAGACACCAAGG	21	19	16	15	5	er	independent
seq1573_all_clean_seqs_gap0_no20_0.4	AACCTGCAGACTTCCTGCCATGTGACCACAGGGTCT	26	24	13	11	13	er	cooperative
seq1574_all_clean_seqs_gap0_no20_0.4	GAGCCACCGGAAACGGAGCTGCGGCCGCGCCCCGCC	22	20	9	8	13	er	cooperative
seq1575_all_clean_seqs_gap0_no20_0.4	CTTCTGGCGGAAGCGGCACAAGCCGCAGTACAGCGC	23	21	9	8	14	er	cooperative
seq1576_all_clean_seqs_gap0_no20_0.4	CTGCACTTCCGGTCAGGCGGTCGGGCTGCGGGGCCC	29	27	8	6	21	er	cooperative
seq1577_all_clean_seqs_gap0_no20_0.4	AATGAAGGAGGGGCAGGATGTGGTCTTGGTGAATCA	21	19	16	15	5	er	cooperative
seq1578_all_clean_seqs_gap0_no20_0.4	TAAAACACCAGGAAACTCTGTGGTGAGTGGGAGGTG	21	19	11	10	10	er	ambiguous
seq1580_all_clean_seqs_gap0_no20_0.4	GCCCACTTCCTGCCGTAAGAGAAAACCACTAACACA	26	24	8	6	18	er	cooperative
seq1581_all_clean_seqs_gap0_no20_0.4	AGTCCTGCCCACTTCCTGCCGCAAGAGAAATCCACT	19	17	14	12	5	er	cooperative
seq1582_all_clean_seqs_gap0_no20_0.4	AGGCCCACCTGCTGCGGATGTGGTCTCTGTGTGTGC	21	19	16	15	5	er	cooperative
seq1584_all_clean_seqs_gap0_no20_0.4	TGTTCAGGAACAGGAAATGAAACCCCGCAGCTTTGA	25	23	13	12	12	er	cooperative
seq1586_all_clean_seqs_gap0_no20_0.4	ACAGGAAATGTTAGAGGTTGAGTTAGCGGTTATGAG	27	25	4	3	23	er	ambiguous
seq1587_all_clean_seqs_gap0_no20_0.4	ACCAGAACAGGAAATGTTAGTGGTTGAGTTAACGGT	21	19	10	9	11	er	cooperative
seq1588_all_clean_seqs_gap0_no20_0.4	GAAGAGGGTGGAGAAGGAAGTGGTCACACCACTTGC	21	19	16	15	5	er	cooperative
seq1589_all_clean_seqs_gap0_no20_0.4	AACCTAGAAAAGGAAGCTGCGGTTTTTCAGGGTATG	20	18	12	11	8	er	ambiguous
seq1590_all_clean_seqs_gap0_no20_0.4	AGACGGTAGGCCAGGAAACCGCAGGCCCCTGCCGGG	19	17	14	13	5	er	independent
seq1592_all_clean_seqs_gap0_no20_0.4	ACACAGGAAGCAAAAGTTAAGCTATAAAACCCGCAA	31	29	6	5	25	er	cooperative
seq1594_all_clean_seqs_gap0_no20_0.4	GGAGCGCGCCGGAAACGCGCGGCTGCGGCCCGGGAG	26	24	11	10	15	er	cooperative
seq1597_all_clean_seqs_gap0_no20_0.4	GAAAAAAATGAGCTTCCTTTAACCACAACTGTATTA	23	21	15	13	8	er	cooperative
seq1601_all_clean_seqs_gap0_no20_0.4	CCCTTGCCAGAGGAAGCCACTGCCACCGCAGAAGCA	26	24	12	11	14	er	cooperative
seq1602_all_clean_seqs_gap0_no20_0.4	CTTACAGTCACAACAGGATGTGGTTTGACATTTACT	21	19	16	15	5	er	cooperative
seq1604_all_clean_seqs_gap0_no20_0.4	AGGCAGCACAGGAAGTTATAACCACATGTACACTTG	22	20	11	10	11	er	cooperative
seq1607_all_clean_seqs_gap0_no20_0.4	GCGGAGCGAGCGGCCGGATGCGGTCACCATAGAGAC	21	19	16	15	5	er	cooperative
seq1609_all_clean_seqs_gap0_no20_0.4	TTTACAGGAAATATCCAGAACAGGTAAACCCACAGA	30	28	7	6	23	er	cooperative
seq160_all_clean_seqs_gap0_no20_0.4	CTGCCGCTGCCTTCCGCCCCCACACACGCACACCAC	20	18	13	11	7	er	independent
seq1611_all_clean_seqs_gap0_no20_0.4	GGCTCGGTGCTGCTTCCTGTGTGGTCAGGATCACAG	22	20	15	13	7	er	cooperative
seq1614_all_clean_seqs_gap0_no20_0.4	AACTGGGCGGAAAGAACGGCTAACCGCAAGCTGCCG	24	22	9	8	15	er	cooperative
seq1615_all_clean_seqs_gap0_no20_0.4	TACATAGGCGGAAGTGGCCTGCGGGCGCCGGAGTTG	22	20	10	9	12	er	cooperative
seq1616_all_clean_seqs_gap0_no20_0.4	GCAGTTTCAAGAGGATGTGGTCTCTTTCACTGCCTG	18	16	13	12	5	er	cooperative
seq1617_all_clean_seqs_gap0_no20_0.4	TCTCTTCCGTTCTCTGGTAGCTTTGTGGTAGCTTTG	26	24	6	4	20	er	cooperative
seq1618_all_clean_seqs_gap0_no20_0.4	TCGTGTTCTCTTCCGTTCTGTGGTAGCTTTTTGGTA	21	19	12	10	9	er	independent
seq1619_all_clean_seqs_gap0_no20_0.4	TGCAAAAAAACAGGAAACACCCAGCCGCAAATTATA	25	23	13	12	12	er	cooperative
seq161_all_clean_seqs_gap0_no20_0.4	GGCGGAAGCTGCCGCTGCCTTGCGCCCCCACACACG	28	26	4	3	24	er	cooperative
seq1624_all_clean_seqs_gap0_no20_0.4	TACCTAGACCCTTTCCGCCCTTACCGCGGCCAGACA	24	22	14	12	10	er	independent
seq1626_all_clean_seqs_gap0_no20_0.4	CTGACGCATTTCCGGCCTTTGCGGTTGATCGGTCAT	22	20	11	9	11	er	cooperative
seq1627_all_clean_seqs_gap0_no20_0.4	ACAGCTCACACAGGAAATACAAACCTCAAAAAGCAA	24	22	13	12	11	er	cooperative
seq1628_all_clean_seqs_gap0_no20_0.4	CTTTGCTGCAGGATGTTCTAACCACAAGCCCAGGAG	22	20	11	10	11	er	cooperative
seq1630_all_clean_seqs_gap0_no20_0.4	ATCTCAACTAGGAAATGTTTTTGTGACCACAAAGGG	27	25	11	10	16	er	independent
seq1631_all_clean_seqs_gap0_no20_0.4	AGGGGAGGAACCAGGAAGTTGTGGTAAACTGTAGCA	22	20	14	13	8	er	cooperative
seq1633_all_clean_seqs_gap0_no20_0.4	TCAGAACCAGGAAACTGAAGGCGGTTACTCCACATA	22	20	10	9	12	er	ambiguous
seq1634_all_clean_seqs_gap0_no20_0.4	GATCTGTGCTCAGGATGTGGTGAGAGAATAAGGAAG	18	16	13	12	5	er	cooperative
seq1635_all_clean_seqs_gap0_no20_0.4	ACCACCCACTTCCCGCGCAGTTCCAAACCGCGACCA	28	26	11	9	17	er	cooperative
seq1636_all_clean_seqs_gap0_no20_0.4	CCCTCAGCGGAAGTGGAAGCTGTGGTTTCCAAAGGC	23	21	9	8	14	er	cooperative
seq1637_all_clean_seqs_gap0_no20_0.4	ACCGAAAACAGGGCCTTCCGCGGTTATACAGATCCT	21	19	17	15	4	er	independent
seq1638_all_clean_seqs_gap0_no20_0.4	GGGCGGGTGAGACCAGGATGTGGGTTCCCCCACCTT	21	19	16	15	5	er	cooperative
seq1640_all_clean_seqs_gap0_no20_0.4	AGCTGTTTGGTCACAGGATGTGGTTATTAGAATAGG	21	19	16	15	5	er	cooperative
seq1641_all_clean_seqs_gap0_no20_0.4	ATTAAAAAAATTTCCTTTGTGGTCACTTAGTTATTA	20	18	13	11	7	er	independent
seq1642_all_clean_seqs_gap0_no20_0.4	GTTGTCTTGCCCAAAGGAAGTGGTTACTAGACCAGA	21	19	16	15	5	er	cooperative
seq1644_all_clean_seqs_gap0_no20_0.4	TGACTTCCGGTCCGTAGTGGGGCCTGCGGTGGGAGT	27	25	6	4	21	er	cooperative
seq1645_all_clean_seqs_gap0_no20_0.4	CCATTTCCGCGCACGTCTGCAGATGCGGTAGTCGAT	26	24	6	4	20	er	cooperative
seq1646_all_clean_seqs_gap0_no20_0.4	ACAGAGCAGGAAGCAGCCCTCACCACAGATGAAGCA	23	21	9	8	14	er	cooperative
seq1647_all_clean_seqs_gap0_no20_0.4	GAGGGCTGCTTCCTGCTCTGTGGAGGCCGCAGCGGG	27	25	11	9	16	er	cooperative
seq1648_all_clean_seqs_gap0_no20_0.4	CCCAGGGCAGGAAGGGCCAAACCGCTACTGCCACTG	22	20	10	9	12	er	cooperative
seq1649_all_clean_seqs_gap0_no20_0.4	GAGGGAGCAGTTCCGGGTGCGGTGCGCGCCAGGGGC	20	18	12	10	8	er	ambiguous
seq1650_all_clean_seqs_gap0_no20_0.4	GCACCGTACCCGGAACTGCTCCCTCCCGCAGGCGCA	26	24	12	11	14	er	independent
seq1651_all_clean_seqs_gap0_no20_0.4	TTCAGGAAATGCAAACGGCTGCAGAGACCGCAGAGG	28	26	5	4	23	er	cooperative
seq1652_all_clean_seqs_gap0_no20_0.4	GCCACTATTTCCTGCCTTCTGCGGCTGAGAGTCCCA	22	20	10	8	12	er	cooperative
seq1653_all_clean_seqs_gap0_no20_0.4	CGCCGAACTTCCGGCAGTAAATTCCGTGGTTTCCCT	27	25	10	8	17	er	cooperative
seq1655_all_clean_seqs_gap0_no20_0.4	TACAATTCGCACCGGAACTTGCGGCCCGGCTTCATT	22	20	14	13	8	er	cooperative
seq165_all_clean_seqs_gap0_no20_0.4	GGGGTCAGGAAATGGGTGTGCCGCGGGTAAGGCGCT	24	22	8	7	16	er	cooperative
seq1660_all_clean_seqs_gap0_no20_0.4	TTCTGTAGCTTAGGATGTGGGTTTCTTTGTTTCTGA	18	16	13	12	5	er	independent
seq1661_all_clean_seqs_gap0_no20_0.4	ACAAAGAAACCTACATCCTAAGCCACAGAATACAGC	23	21	16	14	7	er	independent
seq1662_all_clean_seqs_gap0_no20_0.4	CATGTGCTTCCGGCTTGATCTGTGGTTATTCTGGTT	23	21	9	7	14	er	cooperative
seq1663_all_clean_seqs_gap0_no20_0.4	GCCATCCGCAGGACTCCGCGTTCTCGCGGTAAGTGG	27	25	5	3	22	er	cooperative
seq1664_all_clean_seqs_gap0_no20_0.4	TGATCAGCAAAAGGAAGTGGTTAACATGGCCCAGAA	18	16	13	12	5	er	cooperative
seq1665_all_clean_seqs_gap0_no20_0.4	GAGCATAGCCTAGCAGGATGTGGTTAAATACATTTG	21	19	16	15	5	er	cooperative
seq1666_all_clean_seqs_gap0_no20_0.4	TTTCTCTTCCTGTTTCCACCCTGACCACAGCCAGCT	25	23	8	6	17	er	cooperative
seq1667_all_clean_seqs_gap0_no20_0.4	CAGGGTGGAAACAGGAAGAGAAACCACACTTAACCT	24	22	14	13	10	er	cooperative
seq1669_all_clean_seqs_gap0_no20_0.4	CTTAGTGGGGCAGGATGTGGTCAGGGAAGCTGATCT	18	16	13	12	5	er	cooperative
seq1671_all_clean_seqs_gap0_no20_0.4	GCCGGAAGCCACGCAGGGCCACGTCTGCGGTTCTGA	28	26	4	3	24	er	cooperative
seq1673_all_clean_seqs_gap0_no20_0.4	TGTCCACCTCTACGGAAGTGCGCCGCAGTCCGCCAG	23	21	14	13	9	er	cooperative
seq1674_all_clean_seqs_gap0_no20_0.4	GGGGGCGGAAGTTTCGGTGCATTGTGGGTTCTCCTG	25	23	7	6	18	er	cooperative
seq1675_all_clean_seqs_gap0_no20_0.4	CTTTCGGGGGCGGAAGTTGCGGTGCATTGTAGGTTC	20	18	12	11	8	er	cooperative
seq1676_all_clean_seqs_gap0_no20_0.4	AAGAACCTAGAGGATGTGTGGTTTTATGTGCAGGGT	19	17	12	11	7	er	ambiguous
seq1679_all_clean_seqs_gap0_no20_0.4	GCGGGCGGAAGTGCCGAGGTTGTACCGCGGCGCTGG	25	23	7	6	18	er	cooperative
seq1681_all_clean_seqs_gap0_no20_0.4	TACCAACAGGAATCTTTGGGGTCTAAACCGCAAACA	28	26	9	8	19	er	independent
seq1683_all_clean_seqs_gap0_no20_0.4	ATAGACCCAGCCCGTCCGGTAACCGCGCTCCTCGAT	23	21	15	13	8	er	independent
seq1684_all_clean_seqs_gap0_no20_0.4	TATCGACAAAAGTTCCGGCCCGCGGTAGCGGAGGGA	23	21	14	12	9	er	independent
seq1685_all_clean_seqs_gap0_no20_0.4	ACCTCATCCTGCTGTTCTTGTGTGTGGTTGAGCAGT	25	23	7	5	18	er	cooperative
seq1686_all_clean_seqs_gap0_no20_0.4	GACACAAGAACAGCAGGATGTGGTCAGAGGCGTCGT	21	19	16	15	5	er	cooperative
seq1690_all_clean_seqs_gap0_no20_0.4	TATTCATGACATCCTGTCGGGCTTGTGGGCTGCGTA	26	24	12	10	14	er	cooperative
seq1691_all_clean_seqs_gap0_no20_0.4	AGAACAAAACAGGAAATAGTGGTTTGCAAAAATATA	20	18	12	11	8	er	cooperative
seq1692_all_clean_seqs_gap0_no20_0.4	GAAACCGGAAGCGGCGGCTGTCCGCGGTGCCGGCTG	25	23	7	6	18	er	cooperative
seq1693_all_clean_seqs_gap0_no20_0.4	CAAACAGGTTCCGGCCGGACTACAGCGCCCACAATG	29	27	10	8	19	er	cooperative
seq1694_all_clean_seqs_gap0_no20_0.4	AGCCGTTTCCGGCGCTCTACCCCGCCGCAGGCCGAG	25	23	8	6	17	er	cooperative
seq1695_all_clean_seqs_gap0_no20_0.4	GGAAAAGGAAGTGGCTTTGACTTGCGGGCAGGGAGA	25	23	7	6	18	er	cooperative
seq1696_all_clean_seqs_gap0_no20_0.4	CCATGCACAACAGGATGTGGTTAGACAGTCAAAATT	18	16	13	12	5	er	cooperative
seq1697_all_clean_seqs_gap0_no20_0.4	GGCAACCTGAGCTTCCGTGTAAAACCACAGTGTGAC	25	23	14	12	11	er	independent
seq1701_all_clean_seqs_gap0_no20_0.4	GACATATCCTGCATTCTCAGAAAAACCACAGGCTAG	26	24	7	5	19	er	cooperative
seq1703_all_clean_seqs_gap0_no20_0.4	TCTGGCTTCCTGTCTTAATAGGGCTTTGTGGTGTGC	29	27	8	6	21	er	cooperative
seq1704_all_clean_seqs_gap0_no20_0.4	AGAGCAACAGGATGCAAATAACCACAAGCAAGAATA	22	20	10	9	12	er	cooperative
seq1705_all_clean_seqs_gap0_no20_0.4	TTTGTTGTTCCGGGTGCGAGGCGGCCGCAGCTTCCA	25	23	9	7	16	er	ambiguous
seq1706_all_clean_seqs_gap0_no20_0.4	TGCATGCAACAGGAAGTGGGGTGTGGTTTGTTCTGG	24	22	12	11	12	er	cooperative
seq1707_all_clean_seqs_gap0_no20_0.4	GAGACACTCTGCTTCCTGCGGTGGAAGATTCAGTAT	19	17	14	12	5	er	independent
seq1710_all_clean_seqs_gap0_no20_0.4	CAAGAGCCGGAAGTCCCTTGTGCCGCAGTCCTTCCC	23	21	9	8	14	er	cooperative
seq1711_all_clean_seqs_gap0_no20_0.4	TTTGCTGCAGAAGGATGTGGTTTATTCAGGTTTGAC	18	16	13	12	5	er	cooperative
seq1713_all_clean_seqs_gap0_no20_0.4	GGGGCAGGAAGTGGAGGTTTGAAGTGGTTTAGAGTA	25	23	7	6	18	er	cooperative
seq1714_all_clean_seqs_gap0_no20_0.4	TCCCTTACCTTCCTGCTGCCACCAAACCACCAAACC	27	25	11	9	16	er	independent
seq1716_all_clean_seqs_gap0_no20_0.4	GGTCCGGATGTATAAAGCGCGGCCCCCTGCGGGGAG	30	28	6	5	24	er	ambiguous
seq1717_all_clean_seqs_gap0_no20_0.4	AACAGGCAAAGGACAGGATGTGGTGAGCGTCGGCCC	21	19	16	15	5	er	cooperative
seq1718_all_clean_seqs_gap0_no20_0.4	GCTCATTTATGCATCCTGTGGTCTGTGTGTGTTTCG	19	17	14	12	5	er	cooperative
seq1720_all_clean_seqs_gap0_no20_0.4	CGGCGCCTTCCGCAGAGGGACTGCGGCTTTCTGCGC	24	22	9	7	15	er	cooperative
seq1722_all_clean_seqs_gap0_no20_0.4	ACTGGCTTCACTTCCTCCGCGGTTCCTCGGAGCCGC	20	18	13	11	7	er	cooperative
seq1723_all_clean_seqs_gap0_no20_0.4	CCCACTCCACTTCCGCCACCGCCGCAGCCGCCGCTG	22	20	12	10	10	er	cooperative
seq1725_all_clean_seqs_gap0_no20_0.4	AAGGCGGTACTTCCTCCAGCATTTGCCGCAAGTTAT	26	24	12	10	14	er	cooperative
seq1726_all_clean_seqs_gap0_no20_0.4	GGGACGGGGAGGGCAGGATGTGGTCGCTCTTCCCTC	21	19	16	15	5	er	cooperative
seq1727_all_clean_seqs_gap0_no20_0.4	TTCAACAGGATGTGGGAACTTGACTCTCGCCGCAAA	30	28	8	7	22	er	cooperative
seq1728_all_clean_seqs_gap0_no20_0.4	GCCCAGGGAAGCACTTCCTGCGGGGCGCGGTGCAGC	21	19	16	14	5	er	cooperative
seq1729_all_clean_seqs_gap0_no20_0.4	AGCGACAGCGGATGCTCTCTGGCCGCAACATTCTTT	23	21	10	9	13	er	cooperative
seq172_all_clean_seqs_gap0_no20_0.4	TGAGGGGCTCGCCGGGAAATGTGGTTTAGCGGCCCT	22	20	15	14	7	er	cooperative
seq1730_all_clean_seqs_gap0_no20_0.4	GTGCTAGGACACAGGAAGCGATACCACAAAGAACAT	24	22	14	13	10	er	cooperative
seq1731_all_clean_seqs_gap0_no20_0.4	GTGGCGAAAGTGCGGATGCGAAACCGCTGGCTCGGC	24	22	14	13	10	er	ambiguous
seq1734_all_clean_seqs_gap0_no20_0.4	CTGCTGGCGTTCCCGGATGTGCGGTGGCGGTGCTAC	22	20	15	14	7	er	cooperative
seq1735_all_clean_seqs_gap0_no20_0.4	CCATCTTCATACAGGATGCTGTGGTATGTAAAACAA	22	20	14	13	8	er	cooperative
seq1737_all_clean_seqs_gap0_no20_0.4	TTTCACTTCCGGCATGTTTTTCACCCACAGGGATAT	25	23	8	6	17	er	cooperative
seq1738_all_clean_seqs_gap0_no20_0.4	ATAAACAGGAAGCTGAGTATGTGACCACAGACATTC	25	23	8	7	17	er	cooperative
seq1739_all_clean_seqs_gap0_no20_0.4	TGAGAGTAAAAAGGATGTGGTTTCCTTTCATTTTTT	18	16	13	12	5	er	cooperative
seq1740_all_clean_seqs_gap0_no20_0.4	GAAACAATTTCCTGTACCTCTGTGGTAAAAATGATA	23	21	10	8	13	er	cooperative
seq1741_all_clean_seqs_gap0_no20_0.4	CTTAGTGTTTGAGGATGTGGGTTTTACAATCAGATC	18	16	13	12	5	er	cooperative
seq1744_all_clean_seqs_gap0_no20_0.4	CGGTCAGGTCGCAGGAAACCACAGCGGCAGCGCGGC	19	17	14	13	5	er	cooperative
seq1745_all_clean_seqs_gap0_no20_0.4	TGCAGCTTCCTGTCTGAGGCTTTGTGGTCCTTTCAT	25	23	8	6	17	er	cooperative
seq1746_all_clean_seqs_gap0_no20_0.4	CGTTTCCTGTCTGGGACTGCGCCCACGCGGTCACGT	28	26	5	3	23	er	cooperative
seq1747_all_clean_seqs_gap0_no20_0.4	CCAACACAGGAAATAATTTGAAACCACAATCAGAAA	24	22	9	8	15	er	cooperative
seq1748_all_clean_seqs_gap0_no20_0.4	GACTATGTGCTTCCGGTCTCCAATACCGCAGGAGGG	26	24	12	10	14	er	cooperative
seq1752_all_clean_seqs_gap0_no20_0.4	GAGACAGGAAATGTAGACTTGAGTCCTGTGGTAAAC	29	27	7	6	22	er	cooperative
seq1753_all_clean_seqs_gap0_no20_0.4	AACCAAACAGCCACAGGAAGTGGTTTCTGTGATTCA	21	19	16	15	5	er	cooperative
seq1754_all_clean_seqs_gap0_no20_0.4	AGATGCAAACACAGGAAACTTGTGGTCTATGCTGCT	23	21	14	13	9	er	cooperative
seq1757_all_clean_seqs_gap0_no20_0.4	TGAAGTACTAGTCAAGGATGTGGTTTTACATAGCAG	21	19	16	15	5	er	cooperative
seq1759_all_clean_seqs_gap0_no20_0.4	TGAGAAAGCTATTTCCGCCCACAAAGAGGCAAGTCT	19	17	14	12	5	er	cooperative
seq1761_all_clean_seqs_gap0_no20_0.4	GCCCGCGGCTCCGGAAGCGGCTGCGGCCCCGACCGG	24	22	13	12	11	er	cooperative
seq1763_all_clean_seqs_gap0_no20_0.4	TCTAAATCACTTCCTGTTACAGAAACCACAGGCCTG	26	24	12	10	14	er	cooperative
seq1764_all_clean_seqs_gap0_no20_0.4	TCTGTCGCACATCCGGTGTGAGCTGCGGGGCGGTGG	26	24	12	10	14	er	cooperative
seq1765_all_clean_seqs_gap0_no20_0.4	CAGCTCCGACTTCCGGGTGCGGTACGGCGAAGCAGA	20	18	12	10	8	er	cooperative
seq1766_all_clean_seqs_gap0_no20_0.4	AGCACCCGGAAGTCGGAGCTGCGCACGCACCGCGGG	30	28	8	7	22	er	cooperative
seq1771_all_clean_seqs_gap0_no20_0.4	ACGTCTGTTTCCTGTGATTGAAACCGCAAGAAGAAG	24	22	10	8	14	er	independent
seq1772_all_clean_seqs_gap0_no20_0.4	TTCAATCACAGGAAACAGACGTCACCCACAGACCTA	26	24	11	10	15	er	ambiguous
seq1773_all_clean_seqs_gap0_no20_0.4	CGCCTGCCCCACTTCCGCCCGGACCCGCAGCCCCTA	25	23	14	12	11	er	cooperative
seq1774_all_clean_seqs_gap0_no20_0.4	TTACAATCATTTCCTCTCTGTGGTTTGGTGACAAAT	21	19	12	10	9	er	cooperative
seq1776_all_clean_seqs_gap0_no20_0.4	TCCAGCCCCACCGGAAGTGGATGTGGTTAATCTAGT	24	22	13	12	11	er	cooperative
seq1777_all_clean_seqs_gap0_no20_0.4	CCTGTCCGGAAGTCCTGAGAGGGAATCGCCCGCAAA	30	28	8	7	22	er	cooperative
seq1779_all_clean_seqs_gap0_no20_0.4	TCTGGATTTCCTGTGGGGCTCTCCCACAAGCAGTAC	24	22	9	7	15	er	cooperative
seq1780_all_clean_seqs_gap0_no20_0.4	TCTGTGAAAAAGGATGTGCGGTTATGGAGGAGAACT	19	17	12	11	7	er	cooperative
seq1781_all_clean_seqs_gap0_no20_0.4	CTGAAAAACCGGAAGTGGGTGGTTTGAAACGTAAAT	20	18	11	10	9	er	cooperative
seq1782_all_clean_seqs_gap0_no20_0.4	AGATTTTGTCTTCCTGTTGTGGCAACATCTGTAGAA	20	18	12	10	8	er	cooperative
seq1783_all_clean_seqs_gap0_no20_0.4	GTTTAACAGGAAACCCTGCAGACCACAGGTTCTGTC	23	21	9	8	14	er	cooperative
seq1784_all_clean_seqs_gap0_no20_0.4	ACCCAGTAGGGGCCAGGATGTGGTGAAAAGAGAATT	21	19	16	15	5	er	cooperative
seq1787_all_clean_seqs_gap0_no20_0.4	TTGTCTGCATCCTGTGCTGTGTGGTAGCTCTGGGTT	22	20	10	8	12	er	cooperative
seq1788_all_clean_seqs_gap0_no20_0.4	GGGGCTCCGCAGGAAGTAGGGCTCCCACAACTTTGC	25	23	12	11	13	er	cooperative
seq1789_all_clean_seqs_gap0_no20_0.4	AGCAACAACAAAGGAAGTGGCGGCCGCAGGGGGAGG	24	22	13	12	11	er	cooperative
seq1790_all_clean_seqs_gap0_no20_0.4	ACAGGAAGTGTCTCTATAGAAACCAAACCACAGAAA	28	26	4	3	24	er	independent
seq1792_all_clean_seqs_gap0_no20_0.4	AGCTGAGAGCCTGCCGGAAGCCACAGCTTCTTCTCG	21	19	16	15	5	er	cooperative
seq1794_all_clean_seqs_gap0_no20_0.4	GCCGCGAGTTCCGCCGGGTGGACCACAAATCCCGAG	23	21	10	8	13	er	independent
seq1797_all_clean_seqs_gap0_no20_0.4	CCCCACATCCGGGGGCCGGGGCCGGGCTGTGGGCTT	30	28	8	6	22	er	cooperative
seq1799_all_clean_seqs_gap0_no20_0.4	AGGACGGGCGGAAGTGGCTGCGGTGGATGGTGGGAG	21	19	10	9	11	er	cooperative
seq179_all_clean_seqs_gap0_no20_0.4	CTCTCCACCTCCTTCCGACCAGGACCGCACCCCCCC	25	23	14	12	11	er	independent
seq1801_all_clean_seqs_gap0_no20_0.4	CGCCTACTCTACTTCCGCGGTCGGCCGGGTAAGGAC	18	16	14	12	4	er	cooperative
seq1803_all_clean_seqs_gap0_no20_0.4	ATCACTTGTTTCCGCCAGCAAACCACAGGTCCCCAG	23	21	11	9	12	er	cooperative
seq1804_all_clean_seqs_gap0_no20_0.4	GTTAGCGTGATCGGAGGATGTGGTTTTCCTCCCTCT	21	19	16	15	5	er	cooperative
seq1809_all_clean_seqs_gap0_no20_0.4	AGCCACATCCTCCCTTAGGTCTGACCGCAGCTTAAC	25	23	8	6	17	er	ambiguous
seq1810_all_clean_seqs_gap0_no20_0.4	AGAGACAGCGGGCGGAAACCGCAGAAAAAGTTGAAA	19	17	14	13	5	er	independent
seq1815_all_clean_seqs_gap0_no20_0.4	TTGCTCGGCTTCCTGGAGCTGTGGTCCGTGTGGGCT	22	20	11	9	11	er	cooperative
seq1816_all_clean_seqs_gap0_no20_0.4	AAGAGGAAGTCCCAAATTGCTTTTTAACCACCAACA	28	26	5	4	23	er	independent
seq1818_all_clean_seqs_gap0_no20_0.4	AGGCCAGACGCCTTCCGTGGTTTACGGTGAGGGTGG	18	16	14	12	4	er	independent
seq1819_all_clean_seqs_gap0_no20_0.4	TGTGAACTGACAGGATGTGGTACAAGGCTTACAAAG	18	16	13	12	5	er	cooperative
seq1820_all_clean_seqs_gap0_no20_0.4	TCCAGCGGAAGGGGGCATCTTTGCGGCAGAGGCAGC	24	22	7	6	17	er	independent
seq1822_all_clean_seqs_gap0_no20_0.4	TATCTCCTATCTCCAGGAAGTGGTTAGCCCTAGGAG	21	19	16	15	5	er	cooperative
seq1824_all_clean_seqs_gap0_no20_0.4	TTGAGGGGAAGGGGAGGAAGTGGTCATTGGAACTTG	21	19	16	15	5	er	cooperative
seq1826_all_clean_seqs_gap0_no20_0.4	TGGCAGCCACATCCTGCCTGTGGCTAGGTCAACCCA	21	19	12	10	9	er	cooperative
seq1827_all_clean_seqs_gap0_no20_0.4	GCTCCTCCCGGATATAAAGCCCCAAACCACGCCACT	27	25	10	9	17	er	ambiguous
seq1829_all_clean_seqs_gap0_no20_0.4	GGTTCATTTCCTTTTCCTCCTTGTGGTATAAAAGAG	24	22	9	7	15	er	cooperative
seq1830_all_clean_seqs_gap0_no20_0.4	ACAAGGAGGAAAAGGAAATGAACCACGAATAGCAAA	23	21	14	13	9	er	independent
seq1831_all_clean_seqs_gap0_no20_0.4	ACGACGTCCCGGAAGTGCTGCGGCAATGTTGCTCTT	21	19	11	10	10	er	cooperative
seq1833_all_clean_seqs_gap0_no20_0.4	ATGCCTGTAGGAGGATGTGGTTTCTACACAACTCTG	18	16	13	12	5	er	cooperative
seq1836_all_clean_seqs_gap0_no20_0.4	CACCGCCGGAGTCCCGGATGTGGTTGCTAGGGCAGC	21	19	16	15	5	er	cooperative
seq1838_all_clean_seqs_gap0_no20_0.4	CGCCGGATGCATAAAAGACTGGCTGCGGTGGCTCAG	26	24	5	4	21	er	cooperative
seq1839_all_clean_seqs_gap0_no20_0.4	CCGTACTTCCGCTTTACTCAGATTTTGGACCGCGGG	30	28	8	6	22	er	cooperative
seq1843_all_clean_seqs_gap0_no20_0.4	GCGCACTTCCGGGCTGGTGAACGCGGTGACGTCACC	24	22	8	6	16	er	cooperative
seq1844_all_clean_seqs_gap0_no20_0.4	GACCTGGGTTTCCTGTCTGTACATCGCGGTTCCTAC	27	25	11	9	16	er	cooperative
seq1846_all_clean_seqs_gap0_no20_0.4	GCCACAGCCGGAAGCAGGCTGACCACAAGTGCTAAG	23	21	10	9	13	er	cooperative
seq1847_all_clean_seqs_gap0_no20_0.4	TTGGTCAGCCTGCTTCCGGCTGTGGCTTCAGTTAGT	23	21	15	13	8	er	cooperative
seq1848_all_clean_seqs_gap0_no20_0.4	GGGGCGGCTTCCGGCGGCGTGACCTGACCGCAAGAG	28	26	10	8	18	er	cooperative
seq1849_all_clean_seqs_gap0_no20_0.4	GCACCACCGGAAGTAGGGCTCAACCACCGCTCATTT	24	22	9	8	15	er	cooperative
seq1850_all_clean_seqs_gap0_no20_0.4	TGAGCCCTACTTCCGGTGGTGCTGTGGTCTGCCCCT	25	23	12	10	13	er	cooperative
seq1851_all_clean_seqs_gap0_no20_0.4	CGCCGCTCAACTTCCGGCAACCACAGCTCTCTCTGA	21	19	13	11	8	er	cooperative
seq1853_all_clean_seqs_gap0_no20_0.4	TGGCATTCTCCTTCCTGTCTCCTAACCACAGCCCAC	26	24	13	11	13	er	cooperative
seq1854_all_clean_seqs_gap0_no20_0.4	GTTGTGCTCTTTCCTGCTTCCCGCAGTTTTTTAGTT	21	19	12	10	9	er	cooperative
seq1855_all_clean_seqs_gap0_no20_0.4	GCTTGTCTTCCGGTTTCGTCGCCGCCGCAGGCGCAC	25	23	9	7	16	er	cooperative
seq1857_all_clean_seqs_gap0_no20_0.4	TTTGATTTCCTGTCTCCATGTTGTGGTCAAGATTGC	24	22	8	6	16	er	cooperative
seq1858_all_clean_seqs_gap0_no20_0.4	GACTTGGGGGAAGTGGCTTGGTTTGCGTGGTTTCTC	28	26	9	8	19	er	independent
seq1859_all_clean_seqs_gap0_no20_0.4	CTCTCACTTCCCGTGTGAGAAAAACCACAGAAAAGC	25	23	9	7	16	er	cooperative
seq1860_all_clean_seqs_gap0_no20_0.4	GAGTTCTAGACTACAGGATGTGGTTAGAAGAAAAGA	21	19	16	15	5	er	cooperative
seq1863_all_clean_seqs_gap0_no20_0.4	ATGTCAGGAAGAGGCTCAGGGCTGTGGTTTCTCTGT	25	23	7	6	18	er	independent
seq1864_all_clean_seqs_gap0_no20_0.4	AGCAGGTATACCACTTCCTGTGGTTATCATTTGAGG	21	19	16	14	5	er	cooperative
seq1865_all_clean_seqs_gap0_no20_0.4	TCACATCCTGTAATGGTTTGCGCATACCACAGTTCT	27	25	6	4	21	er	cooperative
seq1866_all_clean_seqs_gap0_no20_0.4	AACCATTACAGGATGTGAGATTCAAACCACTAACAG	27	25	11	10	16	er	cooperative
seq1867_all_clean_seqs_gap0_no20_0.4	CCTTGCAGCAACGGATGTGGGTTTTTTTTTTTCTTT	18	16	13	12	5	er	cooperative
seq1868_all_clean_seqs_gap0_no20_0.4	ACTCCAGAGGAAGTGGCAAGACGAGCGCGGTAACGG	28	26	9	8	19	er	cooperative
seq1869_all_clean_seqs_gap0_no20_0.4	CAGGCCTTTCCTGCTATCGTTTGTGGTTTGAGCAGT	24	22	9	7	15	er	independent
seq1872_all_clean_seqs_gap0_no20_0.4	GCGAGGAGACAACTTCCTTTTGTGGTCTGACCCTGG	23	21	15	13	8	er	cooperative
seq1873_all_clean_seqs_gap0_no20_0.4	CATTGATCAAAGACAGGATGTGGTAACAGGCAGTTA	21	19	16	15	5	er	cooperative
seq1874_all_clean_seqs_gap0_no20_0.4	CGGGCTGGGAGGAAGTGATGGCTGACCACAGAGGAG	26	24	11	10	15	er	cooperative
seq1876_all_clean_seqs_gap0_no20_0.4	AGCAGGAAGTATGTTGAAAGTCATAACCACAGCAAA	27	25	5	4	22	er	independent
seq1881_all_clean_seqs_gap0_no20_0.4	GCTCCGCTTCCGGGAGGCGGGGCTTCTGCGGGTTCC	29	27	9	7	20	er	cooperative
seq1882_all_clean_seqs_gap0_no20_0.4	CAAATGAATAAAGGATGTGGTAAATTATTTTCTTCT	18	16	13	12	5	er	cooperative
seq1883_all_clean_seqs_gap0_no20_0.4	CTACCCTCCCTCTTCCTGTGGTTTCTCAAACATGTC	19	17	14	12	5	er	cooperative
seq1884_all_clean_seqs_gap0_no20_0.4	TTAAACACGGAAGTGCATCGGTTGTTGTGGTTATTC	28	26	9	8	19	er	cooperative
seq1885_all_clean_seqs_gap0_no20_0.4	GCTGCAAGGCGGAAGCAGCGCGGTCGGACGGGCATG	21	19	11	10	10	er	cooperative
seq1886_all_clean_seqs_gap0_no20_0.4	AACTTCCTCCGCGCGGGGCCACTGCTACCACAAAGG	28	26	5	3	23	er	cooperative
seq1889_all_clean_seqs_gap0_no20_0.4	ACCTGTGTTCTGGCAGGATGTGGTTGACCTCAGCAG	21	19	16	15	5	er	cooperative
seq1891_all_clean_seqs_gap0_no20_0.4	GTGGGGCAGGATGTGCTTGCCTGGCTGCGGTTGGAC	28	26	9	8	19	er	cooperative
seq1892_all_clean_seqs_gap0_no20_0.4	CCTAGAACCGGAAGAGAAAGGGGCTGCGGTGCAGCA	27	25	10	9	17	er	cooperative
seq1893_all_clean_seqs_gap0_no20_0.4	AGGAGTGTCACTTCCTCTTTCCTCACCACAGCCTCC	26	24	13	11	13	er	cooperative
seq1896_all_clean_seqs_gap0_no20_0.4	AACATCCTGTGTAAAGAGAATTGAATGTGGTTTTCT	28	26	5	3	23	er	cooperative
seq1898_all_clean_seqs_gap0_no20_0.4	CACTTCCCGTGGGAGGATCTTGGGCTGCGGCTAGGG	28	26	5	3	23	er	cooperative
seq1899_all_clean_seqs_gap0_no20_0.4	TCCTCCCACGGGAAGTGCCGTAGGACCGCAGCCCGA	26	24	11	10	15	er	cooperative
seq1900_all_clean_seqs_gap0_no20_0.4	TCCAAGGCGGAAAAAACCCGCCCTAAACCGCACCCC	28	26	9	8	19	er	independent
seq1901_all_clean_seqs_gap0_no20_0.4	CTCCTTCCTGTGTGTTACTCTTAAAAACCACAGAGG	28	26	6	4	22	er	cooperative
seq1903_all_clean_seqs_gap0_no20_0.4	ACTCCTCCCGCTTCCGCTGCCGCAGCCGGTCGTAAC	20	18	13	11	7	er	cooperative
seq1904_all_clean_seqs_gap0_no20_0.4	AGACGGGACCGGAAGCCGGGCCGCAGGCGGCCGGGC	21	19	11	10	10	er	cooperative
seq1905_all_clean_seqs_gap0_no20_0.4	GAACTTCCGGGACCACGTGACGTAGAACCACAACAA	28	26	6	4	22	er	cooperative
seq1906_all_clean_seqs_gap0_no20_0.4	CCCAATTTCCTTTGCTCTGCTGTCTGCCAACCGCAA	31	29	8	6	23	er	independent
seq1907_all_clean_seqs_gap0_no20_0.4	GATGCTTGTTCAGGATGCGGTTTCTTGCAGCAAGTT	18	16	13	12	5	er	independent
seq1908_all_clean_seqs_gap0_no20_0.4	AACACCACTTCCTACTGTGAAACCACACTGTATTTG	23	21	10	8	13	er	cooperative
seq1910_all_clean_seqs_gap0_no20_0.4	TTTCGAGAAAACCGGAAGTGCGTGGTCACGCCCCGC	23	21	14	13	9	er	cooperative
seq1911_all_clean_seqs_gap0_no20_0.4	GAGGAGATTTCCGGCCCCCATCCCCGCAGCGACCTT	24	22	10	8	14	er	cooperative
seq1913_all_clean_seqs_gap0_no20_0.4	TGTATGAAAAAAACAGGAAACCACAGAGAACTGAGG	21	19	16	15	5	er	cooperative
seq1914_all_clean_seqs_gap0_no20_0.4	CTGACACTTCCGGGAGCCTTGTAGCCACAGGAATCA	25	23	9	7	16	er	cooperative
seq1915_all_clean_seqs_gap0_no20_0.4	AGTTGTGTTTTAGGATGTGGTCAAAGCCCAACAGAG	18	16	13	12	5	er	ambiguous
seq1917_all_clean_seqs_gap0_no20_0.4	TCATTCTCTGATAAAGGAAGTGGTTACAGCACAATT	21	19	16	15	5	er	cooperative
seq1918_all_clean_seqs_gap0_no20_0.4	AAAGTTGTATAGTGAGGATGTGGTCAAGAACTCACC	21	19	16	15	5	er	cooperative
seq191_all_clean_seqs_gap0_no20_0.4	ACTGCTTGATTTTCAGGAAGTGGTAAAGTGGCAGGT	21	19	16	15	5	er	cooperative
seq1921_all_clean_seqs_gap0_no20_0.4	AGGGTTACAATTTCCGTAAACCACAGAAGCAGCAGA	21	19	13	11	8	er	cooperative
seq1922_all_clean_seqs_gap0_no20_0.4	CGGTTCCGGCGCCTGAAGTTTTAGCTGCGGTGGCGG	28	26	5	3	23	er	cooperative
seq1926_all_clean_seqs_gap0_no20_0.4	ACACTGGCCGGAAGGGGCGGGACCGCGAGTTAAGAG	23	21	10	9	13	er	cooperative
seq1927_all_clean_seqs_gap0_no20_0.4	GATTTGTCACAGGAAGTACCCACAGGCCAAGAAGTG	20	18	12	11	8	er	cooperative
seq1928_all_clean_seqs_gap0_no20_0.4	TGGGTACTTCCTGTGACAAATCGAGTTGACCACATG	30	28	9	7	21	er	cooperative
seq1929_all_clean_seqs_gap0_no20_0.4	CTGGAGAGGATGTGGCCCCAGTGTGGTTCTGTAACT	24	22	8	7	16	er	independent
seq192_all_clean_seqs_gap0_no20_0.4	GATGACTTCCTCAGTTCAGGGCTATGTGCGGGGGAG	29	27	8	6	21	er	cooperative
seq1930_all_clean_seqs_gap0_no20_0.4	AGTTTCTCAGCTTCCTGTGTGGTTTTCTTGATCTGC	20	18	13	11	7	er	cooperative
seq1933_all_clean_seqs_gap0_no20_0.4	CACCGGAAAAGGCAAGCGCGGCCGCGCGGTTGGCGC	27	25	5	4	22	er	cooperative
seq1934_all_clean_seqs_gap0_no20_0.4	CCTGCCTGAGGCAGGAAGCCGCAGCTGAGGGACGGC	19	17	14	13	5	er	cooperative
seq1935_all_clean_seqs_gap0_no20_0.4	TTTCCTCGGATTCCCGGATGTGGGTGAGTTCATTTG	21	19	16	15	5	er	cooperative
seq1937_all_clean_seqs_gap0_no20_0.4	CATTCAGTAAAAGGATGTGGTTTAGAACAGATGAAA	18	16	13	12	5	er	cooperative
seq1938_all_clean_seqs_gap0_no20_0.4	GCTCAAGTACCGGAAAGGCCCGCAGAAAGAAGGGCA	20	18	12	11	8	er	cooperative
seq1939_all_clean_seqs_gap0_no20_0.4	GCGCTTCCTGCCAGCTTGGAGGATAACCGCCTACCG	27	25	6	4	21	er	cooperative
seq1940_all_clean_seqs_gap0_no20_0.4	CAAGCTGGCAGGAAGCGCGGTGCAACCACAAGAGTC	26	24	11	10	15	er	cooperative
seq1942_all_clean_seqs_gap0_no20_0.4	AGAGGCAGTTCCGGGGTGGGAACCGCGCGGAGCTTT	23	21	10	8	13	er	cooperative
seq1943_all_clean_seqs_gap0_no20_0.4	GCGGGCAGGATCTTCCTGTGGTTTGCCTTGCCCACT	19	17	14	12	5	er	cooperative
seq1944_all_clean_seqs_gap0_no20_0.4	AGGCAAACTACAGGAAGATCCTGCCCGCAACTTGGT	25	23	13	12	12	er	cooperative
seq1945_all_clean_seqs_gap0_no20_0.4	GTAAGTAGGCCAGGAAGTGGTCACTGCAGCATGTGA	18	16	13	12	5	er	cooperative
seq1947_all_clean_seqs_gap0_no20_0.4	AAATATAGTGCTAAAGGAAGTGGTTTTCATGCAACT	21	19	16	15	5	er	cooperative
seq1949_all_clean_seqs_gap0_no20_0.4	GAGCGGAAACCCGAGAGTCAGTTCAACCACAGCCAC	27	25	5	4	22	er	ambiguous
seq1950_all_clean_seqs_gap0_no20_0.4	AAGAGGAAATAAATACCAGAGTGAACCCACAAACCT	27	25	5	4	22	er	independent
seq1952_all_clean_seqs_gap0_no20_0.4	GGATGAACAGGAAGCTAAAGTAAATACCACAGTGAC	27	25	10	9	17	er	cooperative
seq1953_all_clean_seqs_gap0_no20_0.4	GACAGTTTTCCGGCCTAGTTTGCGGCTGCTCCTGCC	23	21	9	7	14	er	cooperative
seq1957_all_clean_seqs_gap0_no20_0.4	AGGCTGTGGCGGAAGTGGTCGCGTTACCGCTTGTTT	27	25	11	10	16	er	cooperative
seq1959_all_clean_seqs_gap0_no20_0.4	GAGGAGGAAAGCGGAAGCGCTGCCCGCAGTGGTAGG	24	22	13	12	11	er	cooperative
seq1961_all_clean_seqs_gap0_no20_0.4	CACCCAGTTTGAACTTCCTGGCGGTTTTGTTTACAC	22	20	16	14	6	er	cooperative
seq1962_all_clean_seqs_gap0_no20_0.4	CCGCCGCGCGCCGGATGCTAAGACCGCGATTTCCCC	24	22	13	12	11	er	cooperative
seq1963_all_clean_seqs_gap0_no20_0.4	GCCCAGGAAGTGGGTACAAAATGAGCCACAAGACCT	26	24	6	5	20	er	cooperative
seq1964_all_clean_seqs_gap0_no20_0.4	CTTGTGCCTACATCCTGTAGCTGTGGTTTAGGGACG	24	22	13	11	11	er	cooperative
seq1967_all_clean_seqs_gap0_no20_0.4	TGCCACCTGCTTCCTGCCTGTGTAGCCACAAGGGAC	26	24	12	10	14	er	cooperative
seq1969_all_clean_seqs_gap0_no20_0.4	GGCGGGGCATCCGGCAGCACCGCCTGCGGGCGCCCG	27	25	10	8	17	er	cooperative
seq196_all_clean_seqs_gap0_no20_0.4	GCCTCCTTCCTGGGCTCCTTTAAGAGGGTGGTAACG	29	27	8	6	21	er	cooperative
seq1974_all_clean_seqs_gap0_no20_0.4	AACAGTCACATCCGGGGCCGAGAGGAACCGCGAACG	28	26	11	9	17	er	cooperative
seq1975_all_clean_seqs_gap0_no20_0.4	GTTCTCCTTCCTGTGCCGAGTGTGGTTTGCTATCAA	23	21	9	7	14	er	cooperative
seq1976_all_clean_seqs_gap0_no20_0.4	GCGCCGGTGACGGAAGTGCGGTGTTGAGCGCCGGCG	19	17	12	11	7	er	cooperative
seq1977_all_clean_seqs_gap0_no20_0.4	CCTCTTGGTTTCCTGTCCCTCACCACAAGAAGCAGT	23	21	11	9	12	er	cooperative
seq1978_all_clean_seqs_gap0_no20_0.4	GGCAGCCGGCTTCCGGCTGTGGGTGGTGCGGGGGAC	20	18	12	10	8	er	cooperative
seq1979_all_clean_seqs_gap0_no20_0.4	GTTGAGTAGTGACAGGAAGTGACCGCAAGGGGGCGC	23	21	15	14	8	er	cooperative
seq1980_all_clean_seqs_gap0_no20_0.4	AAAGCAAACAGGAAGTGCTGTGGTAACAAGGCCCCA	21	19	11	10	10	er	cooperative
seq1982_all_clean_seqs_gap0_no20_0.4	GGCCAACGAGAGCGCTTCCGGCCGCAGCCACGGCGG	22	20	17	15	5	er	cooperative
seq1984_all_clean_seqs_gap0_no20_0.4	GGCTGGCCTAGGAACTTCCGCCACAAGTCCCGCCCC	21	19	17	15	4	er	cooperative
seq1985_all_clean_seqs_gap0_no20_0.4	GGACACAGGCTTCCGCGTTACCGACACCGCGTGGGG	27	25	12	10	15	er	independent
seq1991_all_clean_seqs_gap0_no20_0.4	AGATGCAGAACAGGAAGTGGTTTAGAAAGCCACTCT	18	16	13	12	5	er	cooperative
seq1993_all_clean_seqs_gap0_no20_0.4	CTTTTCCATGCAGGAAGTGGTTTTTAGAGTGTAGAG	18	16	13	12	5	er	cooperative
seq1994_all_clean_seqs_gap0_no20_0.4	GCGGAGGGAAGCGGAAATACTTGCGGTGGGGGCGAC	24	22	13	12	11	er	cooperative
seq1995_all_clean_seqs_gap0_no20_0.4	TTTCAAAACCCGGAAATGACCGCCAGGCTGGCATCA	20	18	12	11	8	er	cooperative
seq1997_all_clean_seqs_gap0_no20_0.4	ATGGCGGAGCGGAAGTCCCAGCCACAACGCGAAAAG	22	20	11	10	11	er	cooperative
seq199_all_clean_seqs_gap0_no20_0.4	GCCGGGCACCCCGGAAGACCGCTGGGAACCGGCTTT	19	17	13	12	6	er	cooperative
seq2000_all_clean_seqs_gap0_no20_0.4	CAGATCCGGCGTGGACGAAGCTCGGGAACCACAACA	29	27	5	3	24	er	cooperative
seq2001_all_clean_seqs_gap0_no20_0.4	TGAAACCCAGCAGGATGTGGGTTAACGGCAGGGGAG	18	16	13	12	5	er	cooperative
seq2002_all_clean_seqs_gap0_no20_0.4	CAAGGCACCAACGGATGTGGTATCTGGTGAGGGCTT	18	16	13	12	5	er	cooperative
seq2004_all_clean_seqs_gap0_no20_0.4	GCGCGGCGCGACCGGACGCTGCGGGCGGGGAAGAGG	22	20	14	13	8	er	cooperative
seq2005_all_clean_seqs_gap0_no20_0.4	AACAAACAGTAGGCAGGAAGTGGTTAAACCGAAAGG	21	19	16	15	5	er	cooperative
seq2008_all_clean_seqs_gap0_no20_0.4	GGGGGAGCAAGCGCCTTCCGCGGTCGCTGGGGGGAG	21	19	17	15	4	er	independent
seq2009_all_clean_seqs_gap0_no20_0.4	AAGGGAGCCGCCCGGAAACCGCGCGGCAAAGATGCC	19	17	14	13	5	er	cooperative
seq2010_all_clean_seqs_gap0_no20_0.4	AGCCAACAGGAAGCTGCAGAGACTAAACCACAGCAA	28	26	9	8	19	er	ambiguous
seq2012_all_clean_seqs_gap0_no20_0.4	GCCGGCGGCCGGAAGTCTATCCCGCAGAAGCGCAGC	22	20	11	10	11	er	cooperative
seq2015_all_clean_seqs_gap0_no20_0.4	CTCACAACTCGCGTCCGGCGGAGACCACAATTCCCG	25	23	14	12	11	er	cooperative
seq2017_all_clean_seqs_gap0_no20_0.4	CAGATTCCCGGAAAGGGGGACATGTAGCCGCAAAAG	28	26	10	9	18	er	independent
seq2020_all_clean_seqs_gap0_no20_0.4	CCCAGCCCTGCTGCCGGATGTGGTGAGGCCCAGGTG	21	19	16	15	5	er	cooperative
seq2021_all_clean_seqs_gap0_no20_0.4	CCCGGAAACTCAACTGCCCACTGCTGCGGCCGCCAT	27	25	4	3	23	er	ambiguous
seq2022_all_clean_seqs_gap0_no20_0.4	TCTGTCGTCCCACTTCCTGCTGCGGTTTCCACCTCG	23	21	15	13	8	er	cooperative
seq2024_all_clean_seqs_gap0_no20_0.4	TCTCTTCCTGTGATGGAAATACATTGAGGTTTGCGA	27	25	6	4	21	er	cooperative
seq2025_all_clean_seqs_gap0_no20_0.4	GCCGTGGGTACGACCGGAAGCCGCAGGTGGGTGAAG	21	19	16	15	5	er	cooperative
seq2026_all_clean_seqs_gap0_no20_0.4	AATCATTTCCTGCCCTAACGTTTGTGGTCTGCCTAG	25	23	8	6	17	er	cooperative
seq2027_all_clean_seqs_gap0_no20_0.4	AGATGAGGAAGTTGGGGTTTAGAGTGGTTAAACTGT	25	23	7	6	18	er	independent
seq2029_all_clean_seqs_gap0_no20_0.4	CAACACAGGATGTGCAGTATTATACCGCAAAGCACT	25	23	8	7	17	er	cooperative
seq2030_all_clean_seqs_gap0_no20_0.4	TTCACAACACAGGATGTGCGGTATTATACGGCAAAG	19	17	12	11	7	er	cooperative
seq2031_all_clean_seqs_gap0_no20_0.4	TGCTTCTGAGGAAGTGATCTGTGGTCAAAGAAAGAA	22	20	10	9	12	er	cooperative
seq2032_all_clean_seqs_gap0_no20_0.4	GTAGCTCCTCCCACTTCCCGTGGTTTTCGGTTGAAC	21	19	16	14	5	er	cooperative
seq2033_all_clean_seqs_gap0_no20_0.4	AGCTAGGACAGGATGTGAAAACCACACTGACAAAGT	22	20	11	10	11	er	cooperative
seq2034_all_clean_seqs_gap0_no20_0.4	GTGGATTTCACATCCTGTCCTAGCGGTATGTTTGTC	24	22	13	11	11	er	cooperative
seq2035_all_clean_seqs_gap0_no20_0.4	AACACCTCACACTTCCTGCCCACAAGATAAGAGCCT	20	18	14	12	6	er	cooperative
seq2037_all_clean_seqs_gap0_no20_0.4	TTTGTAAGAGGAGGAAGTGGTTTGTAAGAGGAGAAA	18	16	13	12	5	er	cooperative
seq2038_all_clean_seqs_gap0_no20_0.4	AGTACGATGGGAGGAAGTGGTTTGTAAGAGGAGGAC	18	16	13	12	5	er	cooperative
seq2041_all_clean_seqs_gap0_no20_0.4	GCGAGACGCGGAAGAGGCTTGCGGTTGACCAAAGAA	22	20	10	9	12	er	independent
seq2042_all_clean_seqs_gap0_no20_0.4	CCCTACTCAGGAGGATGTGGTTGGAGAACCCGCTGA	18	16	13	12	5	er	cooperative
seq2043_all_clean_seqs_gap0_no20_0.4	AACTGTCTCTACCCAGGAAGTGGTTTTATTTAAAAG	21	19	16	15	5	er	cooperative
seq2046_all_clean_seqs_gap0_no20_0.4	AGTCGGAAGCCATCTGCCCCAACTTGCGGTCTTCAC	27	25	5	4	22	er	ambiguous
seq2047_all_clean_seqs_gap0_no20_0.4	TGATTAAAAACAGGATGTGGGTGAATAGTCATGCAT	18	16	13	12	5	er	cooperative
seq2048_all_clean_seqs_gap0_no20_0.4	CATGGTTGTTATTTCCTCACCACAATATGTGACATT	20	18	14	12	6	er	independent
seq2050_all_clean_seqs_gap0_no20_0.4	CAGACAGGAGGCGGATGTGGGTGGCGCAGAATGAGC	18	16	13	12	5	er	cooperative
seq2051_all_clean_seqs_gap0_no20_0.4	GAGAAAAGAGACTGAGGATGTGGTTTGGGGTGTGGG	21	19	16	15	5	er	ambiguous
seq2052_all_clean_seqs_gap0_no20_0.4	TGAGCACAGTATTTCCTGTGGTTTCTATTGCATTTC	19	17	14	12	5	er	cooperative
seq2053_all_clean_seqs_gap0_no20_0.4	ATAGAAACTACAGGAAATACTGTGGTCAGGTTTTGA	23	21	13	12	10	er	cooperative
seq2054_all_clean_seqs_gap0_no20_0.4	ATGTGCCCAAAGGATGTCACCGCAAAGATCATAGGA	20	18	12	11	8	er	cooperative
seq2056_all_clean_seqs_gap0_no20_0.4	GTGTGCGTGAGAAGAGGAAGTGGTTAGGAAGACACA	21	19	16	15	5	er	cooperative
seq2057_all_clean_seqs_gap0_no20_0.4	TAAGAGATTTCCTGTAAAGGTAACCACCAGCAAAGA	24	22	10	8	14	er	cooperative
seq2058_all_clean_seqs_gap0_no20_0.4	TAAAGAAACAGGATGACTGTGGTTTACTGCGAGCAT	20	18	11	10	9	er	cooperative
seq2059_all_clean_seqs_gap0_no20_0.4	CTAACAGCAGGAAGTGCTTGGTGGTTTAGCACCTCA	22	20	10	9	12	er	cooperative
seq205_all_clean_seqs_gap0_no20_0.4	GGACTGCGTTTCCGGACACTGCGGGTGCCGGTAGCC	22	20	11	9	11	er	cooperative
seq2060_all_clean_seqs_gap0_no20_0.4	CCAAGCACTTCCTGCTGTTAGCTTTGTGGGCTGAGT	27	25	10	8	17	er	cooperative
seq2062_all_clean_seqs_gap0_no20_0.4	AGGGCTGAAACAGGATGTGGTGAGTGAGGTAGGGTG	18	16	13	12	5	er	cooperative
seq2063_all_clean_seqs_gap0_no20_0.4	GACTCCCTCAGCGGATGCGGGTGCTGCTGCTGCTGC	18	16	13	12	5	er	cooperative
seq2064_all_clean_seqs_gap0_no20_0.4	CAGCAGCACCTGCATCCGCTGCGGGAGTCCGAGCCG	22	20	15	13	7	er	cooperative
seq2065_all_clean_seqs_gap0_no20_0.4	AAGGCAAACAGGAAATCATAACCACAAACCAGGAAC	22	20	11	10	11	er	cooperative
seq2067_all_clean_seqs_gap0_no20_0.4	AAACCAGAGAGGAAGTGGCACCACATGGCCAGACTG	21	19	11	10	10	er	cooperative
seq2068_all_clean_seqs_gap0_no20_0.4	GTTCCTTTGAAAGCAGGATGTGGTTTGCCCCAGCTT	21	19	16	15	5	er	cooperative
seq2072_all_clean_seqs_gap0_no20_0.4	AAATGTGGCCGGATGCTCTGTGGGCGGGCGGCAGCT	21	19	11	10	10	er	cooperative
seq2073_all_clean_seqs_gap0_no20_0.4	GCAGAAGGATTTCCTGTTTCAGGCAACCACAGCGAC	27	25	12	10	15	er	cooperative
seq2074_all_clean_seqs_gap0_no20_0.4	ATGGAAAGGAAGTCGGTGGGAAACCGCCTCAGCGGT	24	22	8	7	16	er	cooperative
seq2075_all_clean_seqs_gap0_no20_0.4	CTCCGCCTTTCACTTCCTAGTAACCGCCCTCCCTTG	24	22	15	13	9	er	independent
seq2076_all_clean_seqs_gap0_no20_0.4	GTGGCCTCTTCAACAGGAAACCACAATATTTTTGTT	21	19	16	15	5	er	cooperative
seq2077_all_clean_seqs_gap0_no20_0.4	TGTGGAGACAGGAAGCACTAACCTCAAACCTCTTTC	22	20	11	10	11	er	cooperative
seq2078_all_clean_seqs_gap0_no20_0.4	AACAGCTTCCGGCACGGGGGCTGTGGTTGTGTTGGA	24	22	8	6	16	er	cooperative
seq2079_all_clean_seqs_gap0_no20_0.4	TGCGAGGTTGCCAGGAAACCGCGAAGCCGAGGTCCC	19	17	14	13	5	er	cooperative
seq2081_all_clean_seqs_gap0_no20_0.4	CCAGCCACTTCCGCTCGTCCGCCTAATACCGCGCCT	29	27	10	8	19	er	cooperative
seq2084_all_clean_seqs_gap0_no20_0.4	TACCCAGAAAGGAAGTGGAACCTGCGGTGAGGCCCC	25	23	11	10	14	er	cooperative
seq2085_all_clean_seqs_gap0_no20_0.4	TGTCTCTGCCGCCGGAAACCGCGCCGTAGATCATGC	19	17	14	13	5	er	cooperative
seq2086_all_clean_seqs_gap0_no20_0.4	GCCGTAGCGGAAGAGTGTTCGTGGTCATGTGACGCC	22	20	9	8	13	er	independent
seq2088_all_clean_seqs_gap0_no20_0.4	GCAGCTCTGGCAGGATGCGGTTAAATATGTATCCAC	18	16	13	12	5	er	cooperative
seq2090_all_clean_seqs_gap0_no20_0.4	GGCTTCCTGCCCAACTACCAAGAAAAAGCCACAAAG	29	27	5	3	24	er	cooperative
seq2091_all_clean_seqs_gap0_no20_0.4	CTCTAGAGGCTTCCTGCCCAACCACCAAGAAAAAGC	22	20	12	10	10	er	cooperative
seq2092_all_clean_seqs_gap0_no20_0.4	CCAGTACCCCACTTCCTGACCAAACCACAAAGGTCA	25	23	14	12	11	er	cooperative
seq2093_all_clean_seqs_gap0_no20_0.4	CCCTCATCTTCCTGCTTCAGGCAGCTGTGGTTTACC	28	26	10	8	18	er	cooperative
seq2098_all_clean_seqs_gap0_no20_0.4	CACCTCCTCTCCGGATGCGGTTTGTTCTGCTTGTAG	18	16	13	12	5	er	cooperative
seq2099_all_clean_seqs_gap0_no20_0.4	GCTTCTGAGGAAGTGCGTTCTGTGGGTAGGTGGAGT	23	21	9	8	14	er	independent
seq209_all_clean_seqs_gap0_no20_0.4	CCTCCTCCAGACCATCCTGGAAACCACTGCCGTTCT	24	22	15	13	9	er	independent
seq341_all_clean_seqs_gap0_no20_0.4	CCTCCTCCAGACCATCCTGGAAACCACTGCCGTTCT	24	22	15	13	9	er	independent
seq2101_all_clean_seqs_gap0_no20_0.4	TAGCCGTACGGAAATGTTTGTGGTTCTCTGCATCTA	21	19	10	9	11	er	ambiguous
seq2102_all_clean_seqs_gap0_no20_0.4	GGTTTAACGTTTCCGGTTTGTGGCTAGTTTCTTGTC	21	19	12	10	9	er	cooperative
seq2103_all_clean_seqs_gap0_no20_0.4	TAGCCACGAACCGGAAACGTTAAACCACAGCTCCGT	25	23	13	12	12	er	cooperative
seq2106_all_clean_seqs_gap0_no20_0.4	CCGCTTCCTTAGAGGTTAAGTGGTGGTGGTTCAGTT	27	25	6	4	21	er	cooperative
seq2109_all_clean_seqs_gap0_no20_0.4	CCATCCAGGAAGCTTATGGTGCGACCGCAGTGTGCC	25	23	8	7	17	er	cooperative
seq2110_all_clean_seqs_gap0_no20_0.4	CACCGACCGGAAGGGCCCCAAGGATCCCCGCAGCAG	28	26	9	8	19	er	cooperative
seq2113_all_clean_seqs_gap0_no20_0.4	GAGAGGAGGATGTTGTCAGATACCCACAAATGAGAA	24	22	8	7	16	er	cooperative
seq2114_all_clean_seqs_gap0_no20_0.4	CCCTGACTTTTACGGAAATAGCGGTCCAAAAGCGCC	22	20	14	13	8	er	cooperative
seq2115_all_clean_seqs_gap0_no20_0.4	GACTTTTACGGAAATAGCAGTCCAAAACCGCGTCTA	28	26	10	9	18	er	cooperative
seq2117_all_clean_seqs_gap0_no20_0.4	TGTGTCACTTCCCTATCTGTTGCGGTTGTTCACTCC	23	21	10	8	13	er	ambiguous
seq2118_all_clean_seqs_gap0_no20_0.4	GGGCCCACATCCGGCGCGCGCAACCGCAGCCTACTG	24	22	10	8	14	er	cooperative
seq2120_all_clean_seqs_gap0_no20_0.4	CGGGCGAGCGCAGGATGCGGTTGTCGAACGCGCGGC	18	16	13	12	5	er	cooperative
seq2121_all_clean_seqs_gap0_no20_0.4	GTCAGGGGAACAGGATGTGGGTGGGAGCCAGCCCCA	18	16	13	12	5	er	cooperative
seq2123_all_clean_seqs_gap0_no20_0.4	GGACAGGAAGTTCCTGCAGCTTCTACCACAAACCTA	26	24	6	5	20	er	cooperative
seq2126_all_clean_seqs_gap0_no20_0.4	CTGGGGAGGAAGCCTGAGGTGTGTGGTTTTGTTAAC	24	22	8	7	16	er	independent
seq2127_all_clean_seqs_gap0_no20_0.4	TTGCCATTCCAGGAAATGAGCTTACCACATTGACTG	25	23	12	11	13	er	cooperative
seq2128_all_clean_seqs_gap0_no20_0.4	GCAACAGGAAGGACCAAGTCCCCTCCCGCAATTTTA	26	24	7	6	19	er	ambiguous
seq2129_all_clean_seqs_gap0_no20_0.4	AGTGCAGAGTGGACAGGATGTGGTGGAGGTGAGAGA	21	19	16	15	5	er	cooperative
seq2130_all_clean_seqs_gap0_no20_0.4	CCTCACTAACATCCTGTTGAGGTGTCCCACAAACCA	27	25	12	10	15	er	cooperative
seq2131_all_clean_seqs_gap0_no20_0.4	CCCCCACATCCTGTTTGGTTTGTGGGACACCTCAAC	23	21	9	7	14	er	cooperative
seq2132_all_clean_seqs_gap0_no20_0.4	CAAGGTTCCTCCGCTTCCTGCCCGCAGGCCGAACCT	22	20	16	14	6	er	cooperative
seq2135_all_clean_seqs_gap0_no20_0.4	AGGGACCCGGATGTCTGGTCTGCGGCTGCTCCTCTA	23	21	9	8	14	er	cooperative
seq2136_all_clean_seqs_gap0_no20_0.4	GCTCCTGGCCCGCACTTCCGACCACACACTGGGGAC	22	20	17	15	5	er	cooperative
seq2137_all_clean_seqs_gap0_no20_0.4	CTCTGAGCAGGAAGTGACAAAACCACGCAGGGCAGG	23	21	10	9	13	er	cooperative
seq2138_all_clean_seqs_gap0_no20_0.4	GTTTACAGGGGACAGGAAATGTGGGTGAACTCAGCC	22	20	15	14	7	er	cooperative
seq2142_all_clean_seqs_gap0_no20_0.4	ACGTGATGGCAGTCTTCCTGCCCACAAGTTCTGGTC	22	20	16	14	6	er	independent
seq2143_all_clean_seqs_gap0_no20_0.4	CCTGTACGGAAGCTACTCTGGTTTCATGTGGTTTCA	29	27	8	7	21	er	cooperative
seq2144_all_clean_seqs_gap0_no20_0.4	GAAGCTACTCTGGTTTCCTGTGGTTTTCTGAGCACT	21	19	16	14	5	er	cooperative
seq2145_all_clean_seqs_gap0_no20_0.4	CCTTTACTTCCTTTTACTTCTAACCACAGAATTAAA	24	22	9	7	15	er	independent
seq2147_all_clean_seqs_gap0_no20_0.4	CAGTGAACAGTTTCCTGTTCCTGTGGTTTTGACTTT	24	22	13	11	11	er	cooperative
seq2152_all_clean_seqs_gap0_no20_0.4	TGTTTTTGTTTCCGTTTACAAACCACAACAAAGGTG	23	21	11	9	12	er	cooperative
seq2154_all_clean_seqs_gap0_no20_0.4	GACAGTCATGTTTCAGGATGTGGTTTTAGCCAAAGG	21	19	16	15	5	er	cooperative
seq2157_all_clean_seqs_gap0_no20_0.4	CTCCCCCTTTTTTTCCTGTGGTTTCATTGCATGTTG	19	17	14	12	5	er	independent
seq2158_all_clean_seqs_gap0_no20_0.4	CTTGTTCTATTTCCTGTTTGTGGTGAGTGACTGTCT	21	19	12	10	9	er	cooperative
seq2160_all_clean_seqs_gap0_no20_0.4	CCTACACTTCCCAGAGAACCTAGCGGTTACGCCAAC	24	22	9	7	15	er	independent
seq2163_all_clean_seqs_gap0_no20_0.4	TATGTCTGACTTCCGCTCGTGGTTTCCATCTTAGCC	20	18	12	10	8	er	cooperative
seq2165_all_clean_seqs_gap0_no20_0.4	TCTGGAGAAGCAGGATGTGGTTTGCAAGAGGCTTGC	18	16	13	12	5	er	cooperative
seq2166_all_clean_seqs_gap0_no20_0.4	CTCATCAGTCATCCGGCTGGACCGCAGGAGCTCTCC	22	20	12	10	10	er	cooperative
seq2170_all_clean_seqs_gap0_no20_0.4	GCCGATGAGGAAGTGAGGGCCAACCACACTGCTCAG	24	22	9	8	15	er	ambiguous
seq2172_all_clean_seqs_gap0_no20_0.4	GACATCTTCCGGTTGCTACAGGTTACGGCGGTTGCT	29	27	8	6	21	er	cooperative
seq2173_all_clean_seqs_gap0_no20_0.4	CTGCTGACCAAAACAGGATGTGGTCTACACAAAGTG	21	19	16	15	5	er	cooperative
seq2174_all_clean_seqs_gap0_no20_0.4	AGCTTCCGAGTCTGTTGTGGAGTGGGAACCGCGACT	29	27	5	3	24	er	cooperative
seq2175_all_clean_seqs_gap0_no20_0.4	CTACCGGAAATGCAGCACCACGTAAAATGCGGTCGG	30	28	6	5	24	er	cooperative
seq2176_all_clean_seqs_gap0_no20_0.4	GGACCGGAAGTAGGTTTCTACCCGACCGCATTTTAC	26	24	6	5	20	er	cooperative
seq2178_all_clean_seqs_gap0_no20_0.4	ACCTTCGCCGGATGCTGTGGCTGAAACCACAGCATT	27	25	10	9	17	er	cooperative
seq2179_all_clean_seqs_gap0_no20_0.4	ATTTCCATTTCCGGACTCTTCTCCTGCCCGCAGGGC	28	26	10	8	18	er	cooperative
seq217_all_clean_seqs_gap0_no20_0.4	GCACTACATTTCCCAGCTTTCCTCGCGGTAAAGAGA	26	24	11	9	15	er	independent
seq2180_all_clean_seqs_gap0_no20_0.4	TCCTTAATGGTTCCGGCGGCAGGGACCGCAGCGACG	26	24	12	10	14	er	independent
seq2181_all_clean_seqs_gap0_no20_0.4	TCCCGGCGTTCTTCCGCTGGCTCAGCCGCAAGTACC	26	24	13	11	13	er	cooperative
seq2184_all_clean_seqs_gap0_no20_0.4	ATCTTCCGTAGCAGTCAGGTGTTTTGTGGTTTGCAG	27	25	5	3	22	er	cooperative
seq2187_all_clean_seqs_gap0_no20_0.4	GGGGCTGTGCTTCCGGCTGTTTGTGCGGTTTTGTGC	26	24	12	10	14	er	cooperative
seq2188_all_clean_seqs_gap0_no20_0.4	GACTGGTTTCCTGGTTTTGATGTGGTTTAGAGAAAA	23	21	9	7	14	er	cooperative
seq2191_all_clean_seqs_gap0_no20_0.4	TTCGGATTCCCGGAAGAACCCGCAGCAGCTCCCAGG	20	18	12	11	8	er	cooperative
seq2192_all_clean_seqs_gap0_no20_0.4	GAGACTTTCGCTTCCGGCTGCCGCAGGCGCTTCGCT	21	19	13	11	8	er	cooperative
seq2193_all_clean_seqs_gap0_no20_0.4	TGCGAGCACCCGGAAGCCGCTTGCGGGCTCCCGGAG	24	22	12	11	12	er	cooperative
seq2195_all_clean_seqs_gap0_no20_0.4	TCATATCCGGCAGGAATGGGTTTTGTGGCTTTGTGC	26	24	6	4	20	er	cooperative
seq2196_all_clean_seqs_gap0_no20_0.4	TGAGCACTGAGCACTTCCTGTGGCTTCTGAAGCTCC	21	19	16	14	5	er	cooperative
seq2197_all_clean_seqs_gap0_no20_0.4	GCAGCTGCAAACAGGAAACCACAGCAGCGTAGCGGA	19	17	14	13	5	er	cooperative
seq2201_all_clean_seqs_gap0_no20_0.4	CAGAAAGAGGAAATGATGCGAGTCCACACCGCAGGC	29	27	9	8	20	er	cooperative
seq2202_all_clean_seqs_gap0_no20_0.4	GCCTGCAGCTTCTTCCTGTGGCTTCTGCATCTCAGG	19	17	14	12	5	er	cooperative
seq2203_all_clean_seqs_gap0_no20_0.4	CCGCTGACATCCGCTTGGCCTGCGGCTTCTTTCTGT	23	21	10	8	13	er	cooperative
seq2204_all_clean_seqs_gap0_no20_0.4	TGTCATCCCGGAAACTGATAACAAGACCGCGAGTCA	27	25	10	9	17	er	cooperative
seq2206_all_clean_seqs_gap0_no20_0.4	GTCGTCCCGGAAACCGGGATGCGGTTATCAGAGCGA	22	20	9	8	13	er	cooperative
seq2207_all_clean_seqs_gap0_no20_0.4	GCCGCTGGGTAGGCGGAAGTAGCCGCAGGCATGGCA	23	21	15	14	8	er	cooperative
seq2209_all_clean_seqs_gap0_no20_0.4	GCCTGAGCGGAAACCCGGCGCCACCACAAGATGGCA	24	22	9	8	15	er	cooperative
seq2210_all_clean_seqs_gap0_no20_0.4	TAAATCGGAAACTCGCCGCTCAGCCCGCAGCCGCCG	25	23	7	6	18	er	independent
seq2212_all_clean_seqs_gap0_no20_0.4	CAAGCCAACATCCTGACAGTTTAGAAACCACAGGAG	28	26	11	9	17	er	cooperative
seq2213_all_clean_seqs_gap0_no20_0.4	ACGGTGTGTCTCATTTCCTGTGGGTAACAGGCACCA	21	19	16	14	5	er	cooperative
seq2216_all_clean_seqs_gap0_no20_0.4	TCCCGAGAGCCGGAAGCAGCCGCAGGCCCCGCCACA	20	18	12	11	8	er	cooperative
seq2219_all_clean_seqs_gap0_no20_0.4	CCCCGCCTCTTCCGCTTCTGTGGTCTGATCTGCCTG	21	19	11	9	10	er	cooperative
seq2221_all_clean_seqs_gap0_no20_0.4	GCACAGGCCGGAAGGAAAAGGGTTGTGGGGCTCATT	26	24	10	9	16	er	cooperative
seq2222_all_clean_seqs_gap0_no20_0.4	GAGCACAGGAAAAGCTGGTGCCAACCACAAGTGCTT	25	23	8	7	17	er	cooperative
seq2224_all_clean_seqs_gap0_no20_0.4	GCCCAGGCAGGAAGCCAGGCGCCCACAGGTTGGCAG	23	21	10	9	13	er	cooperative
seq2228_all_clean_seqs_gap0_no20_0.4	AGCGGCCTGGGAGGAGGATGTGGTTACGTGGAGACC	21	19	16	15	5	er	cooperative
seq2229_all_clean_seqs_gap0_no20_0.4	CAGGAGCAGTGTAGAGGAAGTGGTTTCCATCACGGA	21	19	16	15	5	er	cooperative
seq2231_all_clean_seqs_gap0_no20_0.4	TGAGTCACAGAGACAGGATGTGGTGCAGGGGGTATT	21	19	16	15	5	er	cooperative
seq2232_all_clean_seqs_gap0_no20_0.4	AGCGGCCGAAGGAAGTGACGTTTGCGGCAGTAAGGC	25	23	11	10	14	er	cooperative
seq2235_all_clean_seqs_gap0_no20_0.4	ACAGGAAATGACATCAGAATCTCCAAACCACAACCA	28	26	4	3	24	er	independent
seq2236_all_clean_seqs_gap0_no20_0.4	TCGCCCGCCGCTTCCTGTCGCGGCGCCGCAGAGGCC	26	24	13	11	13	er	cooperative
seq2237_all_clean_seqs_gap0_no20_0.4	GGCCGTTCTTCCGCCTGCAGGGTGGTCAGCGGAGGT	23	21	10	8	13	er	cooperative
seq2238_all_clean_seqs_gap0_no20_0.4	GGCCAGGCAGGAAGTCCCGCGCCACAAGCGGCCGTC	22	20	10	9	12	er	cooperative
seq2239_all_clean_seqs_gap0_no20_0.4	GGTTTCGCTTCCGGGTTAGGCGGCCGCAGAAGCGTA	24	22	10	8	14	er	cooperative
seq2240_all_clean_seqs_gap0_no20_0.4	GAGGGGTGGGGGAGGAAGGCTGCGGTTTCTGCTGGG	23	21	14	13	9	er	independent
seq2241_all_clean_seqs_gap0_no20_0.4	AAGTTCTTCCGGGTCTGCAGTCTGTGGTGTGTTTGC	25	23	8	6	17	er	cooperative
seq2243_all_clean_seqs_gap0_no20_0.4	CCGATTTCCCCGGACGTGGTGAGACCGCGCTTCGTC	25	23	12	11	13	er	cooperative
seq2244_all_clean_seqs_gap0_no20_0.4	TCCCACTGCGACGGAAGCACAGCGGTTAAGATTGCA	23	21	13	12	10	er	cooperative
seq2245_all_clean_seqs_gap0_no20_0.4	TGCAGTCTCAACTTCCTGCGGTCAAGTGATCCTTCA	19	17	14	12	5	er	independent
seq2247_all_clean_seqs_gap0_no20_0.4	CGGCAGGCAAGCAGGAAACCGCGAGTGGAGAAAGGG	19	17	14	13	5	er	cooperative
seq2249_all_clean_seqs_gap0_no20_0.4	AGCTTGACGAAGGCTTCCTGTGGTTTGGGTTGATGT	21	19	16	14	5	er	cooperative
seq2251_all_clean_seqs_gap0_no20_0.4	GTTCAGCAGGAAGTGGATGTGGATGTGTGGTTGCCA	28	26	9	8	19	er	cooperative
seq2252_all_clean_seqs_gap0_no20_0.4	GAGGGGAGGATGTCTGAGCTTTTAATTGTGGTTTCA	29	27	8	7	21	er	ambiguous
seq2253_all_clean_seqs_gap0_no20_0.4	GTATGGGAAGTGATCTGGCTGCAAACCGCAAGAGAG	26	24	6	5	20	er	cooperative
seq2256_all_clean_seqs_gap0_no20_0.4	CCTGCCGAGGAAGTCCCACGTCACTGCGGTTAGAGT	27	25	9	8	18	er	independent
seq2257_all_clean_seqs_gap0_no20_0.4	ATACAGACACAGGAAGTTGTGGGGAGTGCAAAAGCC	20	18	12	11	8	er	cooperative
seq2259_all_clean_seqs_gap0_no20_0.4	GGTGGCAACATCCTGGGGAGGGGAACCCACAGGGGA	27	25	11	9	16	er	independent
seq225_all_clean_seqs_gap0_no20_0.4	TTTATCATGAATGCAGGATGTGGGCAAACTCGCATC	21	19	16	15	5	er	cooperative
seq2260_all_clean_seqs_gap0_no20_0.4	GCTTCTTCAGCCACATCCTGACCACAGCCCAGATTC	22	20	16	14	6	er	cooperative
seq2262_all_clean_seqs_gap0_no20_0.4	CGACAGAGGACACTTCCTTTTGCGGGTGGCGGCGAA	23	21	15	13	8	er	cooperative
seq2264_all_clean_seqs_gap0_no20_0.4	TCCCGGGGAGGAAGTGGCGAGAATGCGGGGGTGGGC	26	24	10	9	16	er	cooperative
seq2266_all_clean_seqs_gap0_no20_0.4	GACACAAGACAGTTTCCGTCAGTGGTTAAGCCCTAA	23	21	15	13	8	er	independent
seq2267_all_clean_seqs_gap0_no20_0.4	GCTGCTTCCGGCCGCTGGTCGCAGGGCTGCGGGACT	30	28	7	5	23	er	cooperative
seq2268_all_clean_seqs_gap0_no20_0.4	ATGTCTTCCTGTACAGGAACTGGGTCCCAGCCGCAG	31	29	7	5	24	er	cooperative
seq226_all_clean_seqs_gap0_no20_0.4	ACTCGGGAATGTCCGGTCGTGGTAAGCAGGGTGGCA	20	18	12	10	8	er	cooperative
seq2271_all_clean_seqs_gap0_no20_0.4	CTCCTCCCCCACTTCCTATTTTTACCGCAGTTGCAC	25	23	14	12	11	er	independent
seq2272_all_clean_seqs_gap0_no20_0.4	CGCCTCATTTCCTGTGCAACTGCGGTAAAAATAGGA	23	21	10	8	13	er	cooperative
seq2274_all_clean_seqs_gap0_no20_0.4	GGTTCGCGGCTTCCGGGACATTTGTACCGCAGGGGG	27	25	12	10	15	er	cooperative
seq2276_all_clean_seqs_gap0_no20_0.4	ACCCCAGGTACCGGAAGACCACAATTCCCAGGAGTC	19	17	13	12	6	er	cooperative
seq227_all_clean_seqs_gap0_no20_0.4	TTGACTCGGGAATGTCCGGTCGTGGTAAGCAGGGTG	23	21	15	13	8	er	cooperative
seq2281_all_clean_seqs_gap0_no20_0.4	ATCACAAGCAGAGGATGTGGTTAGTGTTTCGTTCCA	18	16	13	12	5	er	cooperative
seq2284_all_clean_seqs_gap0_no20_0.4	AAGTTGATTTCCGGGTAGTCTGTGGTTTCCTAATCA	23	21	10	8	13	er	cooperative
seq2286_all_clean_seqs_gap0_no20_0.4	CCAGAATGCAGGAAGTGCTGTGGTTTGACTTTGTTT	21	19	11	10	10	er	cooperative
seq2287_all_clean_seqs_gap0_no20_0.4	AGGGCATAAACAGGATGTGGTGTTGGATGAAACCTT	18	16	13	12	5	er	cooperative
seq2288_all_clean_seqs_gap0_no20_0.4	TCCTTTTCCGGTGGCGGCGCCGCGCGGTGAGGTTGT	25	23	7	5	18	er	cooperative
seq2289_all_clean_seqs_gap0_no20_0.4	CTGTGAGGCGGAAGTGGCGGGCTCTGTGGGCGCAAG	27	25	10	9	17	er	cooperative
seq228_all_clean_seqs_gap0_no20_0.4	CTGTTTCCGAGTAAAGTAGGGTGTGTGGGTCACATG	26	24	6	4	20	er	independent
seq2290_all_clean_seqs_gap0_no20_0.4	AGGCCCCGCCCCTTCCGCCCACAGAGCCCGCCACTT	19	17	14	12	5	er	cooperative
seq2291_all_clean_seqs_gap0_no20_0.4	CTTTAAGGAGGCGGAAAAGTTAACCGCGATGGGCAG	24	22	13	12	11	er	ambiguous
seq2295_all_clean_seqs_gap0_no20_0.4	CAGATTCAAGGAAGTGGTGGTGGTTTGGTGTCGTTG	21	19	10	9	11	er	cooperative
seq2297_all_clean_seqs_gap0_no20_0.4	CTGACAGTTACTTCCTGTCTTTGTGGGCGATTGTGA	24	22	13	11	11	er	cooperative
seq2298_all_clean_seqs_gap0_no20_0.4	GAGCAAACGGAGGCAGGAAGTGGTTATGTAACTTCA	21	19	16	15	5	er	cooperative
seq2299_all_clean_seqs_gap0_no20_0.4	GCGAGCACTTCCGGTGTGTGAGCCTGCGGTTGCTAC	27	25	10	8	17	er	cooperative
seq229_all_clean_seqs_gap0_no20_0.4	TCTGGCTGGGTGTTGGGATGTGGTTAACCGGGTTGG	21	19	16	15	5	er	independent
seq2301_all_clean_seqs_gap0_no20_0.4	GGGCGGAAGTGCGTCACTATGTCCGACCCGCAGTGC	28	26	5	4	23	er	cooperative
seq2302_all_clean_seqs_gap0_no20_0.4	GCCCCAGCCCCCGGATGTGGTGACAGAATCGATACT	18	16	13	12	5	er	cooperative
seq2303_all_clean_seqs_gap0_no20_0.4	TACTACTTACCAGCAGGATGTGGTCCCTGCCCACTG	21	19	16	15	5	er	cooperative
seq2304_all_clean_seqs_gap0_no20_0.4	TGGGGCTCTTCCTGCTTATGTGACCACAGCACCTTG	24	22	10	8	14	er	cooperative
seq2306_all_clean_seqs_gap0_no20_0.4	CCCAGAGCTTCCGATTGGCTCTTCTGTGGTGGCGGG	27	25	10	8	17	er	cooperative
seq2307_all_clean_seqs_gap0_no20_0.4	GGACCGGAAGTTAAGGCGTTCGCGGCGTGTGGTAAG	30	28	6	5	24	er	cooperative
seq2308_all_clean_seqs_gap0_no20_0.4	CCCCGCGGAACTCTGGCACAGTCAGCTGACCGCAGA	30	28	7	6	23	er	independent
seq2309_all_clean_seqs_gap0_no20_0.4	GCTTGCTCCCACAGGAAACCGCAGGCTTCGGGCACA	19	17	14	13	5	er	independent
seq2310_all_clean_seqs_gap0_no20_0.4	CACGCCTGCGGAAGATGAAAACCACACGTCATGCAG	22	20	10	9	12	er	ambiguous
seq2313_all_clean_seqs_gap0_no20_0.4	ACATTCTTCCGGTTGGACCTCCGCGGTCAGCGCTGT	24	22	8	6	16	er	cooperative
seq2314_all_clean_seqs_gap0_no20_0.4	GAAAACACAGGAAGCCGTCCGCGCAACCGCGTTGCA	27	25	10	9	17	er	cooperative
seq2315_all_clean_seqs_gap0_no20_0.4	CACCCGAACGGAAACACCTGCGGCTGAGGGGAGGGG	21	19	10	9	11	er	ambiguous
seq2316_all_clean_seqs_gap0_no20_0.4	GGCACCGGAAGTAGAGCTGCCCCTAGTTGCGGCAGT	30	28	7	6	23	er	cooperative
seq2317_all_clean_seqs_gap0_no20_0.4	GTCGGAAGTGGCCGTGAGCCCAAGCCGCGGTCCCGG	28	26	4	3	24	er	independent
seq2318_all_clean_seqs_gap0_no20_0.4	CGGGTGGTGGCAGGATGTGGGTAGGGGGCCAGGCGA	18	16	13	12	5	er	cooperative
seq2319_all_clean_seqs_gap0_no20_0.4	GGGTGAGTATTTCCTCCTGCGGTGGGTCGGCATGTA	20	18	12	10	8	er	cooperative
seq231_all_clean_seqs_gap0_no20_0.4	CACCTGCGGAAGTCACAGGGAAGCCACAGAGAGATG	24	22	8	7	16	er	cooperative
seq2320_all_clean_seqs_gap0_no20_0.4	ACCACGAGCCCAGGATGCGGTTTATGCGCTGTCGGG	18	16	13	12	5	er	independent
seq2321_all_clean_seqs_gap0_no20_0.4	CCTTGCTACAGGATGTTTTGACCACGAGCCCAGGAG	22	20	11	10	11	er	cooperative
seq2322_all_clean_seqs_gap0_no20_0.4	ACTGAAAACAGCACAGGATGTGGTCTGCCAGGTGCC	21	19	16	15	5	er	cooperative
seq2324_all_clean_seqs_gap0_no20_0.4	GGAGCATCCCGGAAGTCGTCACTGCGGCCGCTCCCG	25	23	11	10	14	er	cooperative
seq2326_all_clean_seqs_gap0_no20_0.4	GGCGGGACTTCCGGCGTCTCCCCTCGGCGGTTGCTT	28	26	10	8	18	er	cooperative
seq2327_all_clean_seqs_gap0_no20_0.4	AGCTTGCCGGAAGCTGGTTGTTCGCTGCGGCGACCA	28	26	9	8	19	er	cooperative
seq2329_all_clean_seqs_gap0_no20_0.4	TCTTCAGGCGTCTTTCCGGTGGTGGTCGTTTTTGCT	23	21	15	13	8	er	cooperative
seq2330_all_clean_seqs_gap0_no20_0.4	TTACCCCGGCGGAACGGAGGCCTGCGGTCGCGGCGG	25	23	11	10	14	er	independent
seq2331_all_clean_seqs_gap0_no20_0.4	GGGGCCTCTGCTACTTCCTAGACCGCAAAATGGAGA	23	21	16	14	7	er	independent
seq2332_all_clean_seqs_gap0_no20_0.4	GGGAGGCCCCATCCTGTGTGGCTGTGGCTTTTGCCT	25	23	12	10	13	er	independent
seq2334_all_clean_seqs_gap0_no20_0.4	CTAAGCAGAGGCCGGAAGCGGTGGTTTTTAGCGGCT	22	20	14	13	8	er	cooperative
seq2335_all_clean_seqs_gap0_no20_0.4	CTGCCCACCGGAAACGATGGCGCGAGGCCGCAGAGC	28	26	10	9	18	er	cooperative
seq2336_all_clean_seqs_gap0_no20_0.4	GGTGACACGGCCGGCTTCCTGCCGCAGAGCTCCTGG	22	20	17	15	5	er	cooperative
seq2337_all_clean_seqs_gap0_no20_0.4	GACATCCAGGAAGTGGTGAGAAACCACGTGTGTGTT	24	22	9	8	15	er	cooperative
seq2338_all_clean_seqs_gap0_no20_0.4	CCCAAGCTACGGAAGTTAAACCTCAAACATGAAATC	21	19	11	10	10	er	cooperative
seq233_all_clean_seqs_gap0_no20_0.4	TCCTGTAGTTTCCGGCTGAAGTGGTAAGGTTTTTGA	22	20	11	9	11	er	cooperative
seq2340_all_clean_seqs_gap0_no20_0.4	CGTACGCGCACTTCCGGTCTTTGTGGCTTGCAGCTC	24	22	13	11	11	er	cooperative
seq2341_all_clean_seqs_gap0_no20_0.4	GCTCATTTCCTGGCCGCTCCTGGGCTTCGCGGTGAG	30	28	8	6	22	er	cooperative
seq2342_all_clean_seqs_gap0_no20_0.4	GGCGCGGGCTGCTTCCGGTCTGCGGGCCTGAGGAGG	23	21	14	12	9	er	cooperative
seq2346_all_clean_seqs_gap0_no20_0.4	CTGAGCCGGATGTTACTGGTTAGTGGTTTTCTTTAT	24	22	8	7	16	er	cooperative
seq2347_all_clean_seqs_gap0_no20_0.4	GCTGCCACTTCCCTTGCTTATTTCATGTGGTTTGGA	28	26	10	8	18	er	cooperative
seq2348_all_clean_seqs_gap0_no20_0.4	TGTCAGCTGCGTTTCCGCGGTCGCGGGTGAGTGTGC	18	16	14	12	4	er	cooperative
seq2349_all_clean_seqs_gap0_no20_0.4	ACTAGAAGCGGAAGTAGTTGTGGGCGCCTTTGCAAC	21	19	10	9	11	er	cooperative
seq2350_all_clean_seqs_gap0_no20_0.4	ACCCTGAAATTACCCGGATGTGGTCCCCGCGCGCGC	21	19	16	15	5	er	cooperative
seq2351_all_clean_seqs_gap0_no20_0.4	CGGAGGCGGCCGGAAGTAGCGCTGCGGTTGGCAGCT	25	23	12	11	13	er	cooperative
seq2353_all_clean_seqs_gap0_no20_0.4	CTGAAACAGGAAGCTGAGGGTGCGGTTGGGGGAGGA	23	21	9	8	14	er	cooperative
seq2355_all_clean_seqs_gap0_no20_0.4	CTGAAGAGGAAATGTATTCCTCATGTTGTGGTTGGC	29	27	8	7	21	er	independent
seq2356_all_clean_seqs_gap0_no20_0.4	TTCAACAAGGTTTTCCTGTGGTTACCCCATGCTTTG	19	17	14	12	5	er	cooperative
seq2357_all_clean_seqs_gap0_no20_0.4	GTTGGGCTTTGAGGATGTGGGTTCTAGAAGTTTACA	18	16	13	12	5	er	independent
seq2358_all_clean_seqs_gap0_no20_0.4	GGGAGGTCACATCCTGCCCGCGGTCTCAGAAAAGCT	21	19	12	10	9	er	cooperative
seq2361_all_clean_seqs_gap0_no20_0.4	GGGAACTCACACCGGAAACCACAGAACCAAGAGTGG	19	17	14	13	5	er	independent
seq2362_all_clean_seqs_gap0_no20_0.4	GCACACCGGAACTCACACCTGAAACCACAGAACCAA	25	23	8	7	17	er	cooperative
seq2363_all_clean_seqs_gap0_no20_0.4	CTCCGGCGGAAGTTGTCTCTTCGCCGCCGCCGCAGC	30	28	8	7	22	er	cooperative
seq2364_all_clean_seqs_gap0_no20_0.4	CCCCTCTCTCCCACTTCCTGTGGTCTCAGTCTTTGT	21	19	16	14	5	er	cooperative
seq2365_all_clean_seqs_gap0_no20_0.4	GACTTCCTGTTGAAGATTGGCCTCTGCGGTACCACG	27	25	5	3	22	er	cooperative
seq2366_all_clean_seqs_gap0_no20_0.4	CTTTGTTGAAAAGGATGTGGTCATCTGATCTTGCTG	18	16	13	12	5	er	cooperative
seq2367_all_clean_seqs_gap0_no20_0.4	GAGTGGGCGGAAATCCGTGCCTGGCAGACCACAAAG	29	27	9	8	20	er	cooperative
seq2368_all_clean_seqs_gap0_no20_0.4	AGGTGTACTTTCCGGGTGCAGACCGCGAATGGATCG	23	21	11	9	12	er	independent
seq2371_all_clean_seqs_gap0_no20_0.4	GCCAGGGCAGGAAGTTGCTAACCGCCCCAGAGCAGG	22	20	10	9	12	er	cooperative
seq2373_all_clean_seqs_gap0_no20_0.4	GCGACCCGACCCGGCGGAAACCACCTCGACAGCCTC	21	19	16	15	5	er	independent
seq2374_all_clean_seqs_gap0_no20_0.4	GGGCATGGTGGCTTCCGACCGCGGGGACCCCGAGAG	19	17	14	12	5	er	cooperative
seq2376_all_clean_seqs_gap0_no20_0.4	GACATGCTCCGGAAGCTTGAGGTTTTAACGTTAAGG	20	18	11	10	9	er	cooperative
seq2378_all_clean_seqs_gap0_no20_0.4	GCCACACAGGCAGGAAAGCCACAGCCCACGTCTCCG	19	17	13	12	6	er	independent
seq2379_all_clean_seqs_gap0_no20_0.4	GATACCTAGAAGCCAGGAAACCGCGAGCTGCAGTCC	21	19	16	15	5	er	independent
seq237_all_clean_seqs_gap0_no20_0.4	ACTACAGGAGGAAACTACAGCCTAAACCACATGCAA	27	25	10	9	17	er	ambiguous
seq2380_all_clean_seqs_gap0_no20_0.4	GGCGGCACTAGGCTTCCGCCTCACCGCAGTGGGGTT	24	22	15	13	9	er	cooperative
seq2381_all_clean_seqs_gap0_no20_0.4	TCCGCCCGCGGATGCTGAGAACCGCAGCTGCACAAG	22	20	10	9	12	er	independent
seq2382_all_clean_seqs_gap0_no20_0.4	CTTACCTACAGTTCCGCTTGCTGTGGTTTCAGTTAC	24	22	13	11	11	er	cooperative
seq2383_all_clean_seqs_gap0_no20_0.4	GGCCGACGGGAAGTGTAGTCCGGCCTGCGGTCCGGG	28	26	9	8	19	er	cooperative
seq2384_all_clean_seqs_gap0_no20_0.4	GGCTTCCGCCTGCCGAGCGGCCCCGGACCGCAGGCC	28	26	5	3	23	er	cooperative
seq2385_all_clean_seqs_gap0_no20_0.4	CCAGACCCGGCGGAACTACCGTGCCCACAAGGCAGC	25	23	12	11	13	er	independent
seq2386_all_clean_seqs_gap0_no20_0.4	CGGGGCTTCCGGCGCGCTGCCTTGTGGGCACGGTAG	25	23	8	6	17	er	cooperative
seq2389_all_clean_seqs_gap0_no20_0.4	GTGGAAAGGAAATGTGTCATCTGTGGTTTGGTTTTA	24	22	8	7	16	er	independent
seq238_all_clean_seqs_gap0_no20_0.4	AAACTACTTTCCTTCCTACCAAAACCACACTAAAGA	25	23	14	12	11	er	independent
seq2391_all_clean_seqs_gap0_no20_0.4	TGAAGCCATGGTTTCCTGTCTGCGGCTCAGATCAAG	23	21	14	12	9	er	cooperative
seq2392_all_clean_seqs_gap0_no20_0.4	TCAAGTTTGGTAACAGGATGTGGTAGGAGGAACACA	21	19	16	15	5	er	cooperative
seq2394_all_clean_seqs_gap0_no20_0.4	TCCGGAAATAGATAATATCTAGTTAAACCTCAAAAT	28	26	4	3	24	er	cooperative
seq2397_all_clean_seqs_gap0_no20_0.4	AGAAGCTGCACCCGGAAATGAAACCACCAGGACCTC	24	22	14	13	10	er	cooperative
seq2398_all_clean_seqs_gap0_no20_0.4	TCTAGTTCTGGTTTCCGGACCGCATTCGGAACTAGA	20	18	14	12	6	er	cooperative
seq2399_all_clean_seqs_gap0_no20_0.4	CCCTCCTCTTTCGTTTCCTAACCGCAAATTCCATCA	22	20	16	14	6	er	independent
seq2402_all_clean_seqs_gap0_no20_0.4	GTTAGAGGAAGAGGAAGCGGTCAAGAGATCGTCACA	18	16	13	12	5	er	cooperative
seq2403_all_clean_seqs_gap0_no20_0.4	TCTGGGGGAGGGGAAGGATGTGGTTTGCAGAGCGGA	21	19	16	15	5	er	cooperative
seq2404_all_clean_seqs_gap0_no20_0.4	CTGCCTGGCACAGGATGTGGTCATTTGTGCTGAGGA	18	16	13	12	5	er	cooperative
seq2405_all_clean_seqs_gap0_no20_0.4	CCACGTAAAGGCGGAAGCGGTTGAGTGGACGCCATC	18	16	13	12	5	er	cooperative
seq2406_all_clean_seqs_gap0_no20_0.4	TGGCTGTCACTTCCTGTCCCACTGTGGTTCCTGGGA	25	23	12	10	13	er	cooperative
seq2407_all_clean_seqs_gap0_no20_0.4	CCCCACCCAGACAGGAAACTGTGGCTTCTATCAGAT	22	20	14	13	8	er	cooperative
seq2408_all_clean_seqs_gap0_no20_0.4	AAATACCAGCCCACTTCCTGTGGCTTTGATCTGCAG	21	19	16	14	5	er	cooperative
seq2409_all_clean_seqs_gap0_no20_0.4	AGCTCAATTTCCTGGCGTGTAACATGGCCACAAGGG	28	26	10	8	18	er	cooperative
seq2410_all_clean_seqs_gap0_no20_0.4	TGACTAAGACCGGAAGAAACCACAAAAACACAAAAA	20	18	12	11	8	er	independent
seq2411_all_clean_seqs_gap0_no20_0.4	AGCTTGCGCAGGAAGTCTGCGGCAGGAGGGCGTCCT	20	18	11	10	9	er	cooperative
seq2412_all_clean_seqs_gap0_no20_0.4	TCCCTCATGAGCTTCTTCCGCCCGCAACACGAGACT	22	20	17	15	5	er	cooperative
seq2413_all_clean_seqs_gap0_no20_0.4	TTACACAACAGGAAACTATGTTTAGCGGTTAATCCA	26	24	11	10	15	er	cooperative
seq2415_all_clean_seqs_gap0_no20_0.4	GGCCGGGGGCAGGAAGCTGCGGCGCTGGCTCCCCCC	20	18	12	11	8	er	cooperative
seq2416_all_clean_seqs_gap0_no20_0.4	AACTGCCTGGTGGCCGGAAACCGCTGGAGGGAGGGC	21	19	16	15	5	er	cooperative
seq2417_all_clean_seqs_gap0_no20_0.4	CACCTGGCCCGGACGGCTGCGGTCTGGAGGGCTGTC	20	18	11	10	9	er	independent
seq2418_all_clean_seqs_gap0_no20_0.4	GCCATTAAAGCAGCTTCCTGTGGGCGCGGCGCAGGA	21	19	16	14	5	er	cooperative
seq2419_all_clean_seqs_gap0_no20_0.4	GCGCAGGTCCCGGATGTTGCGGACAGTATGAGGCAA	20	18	12	11	8	er	cooperative
seq2421_all_clean_seqs_gap0_no20_0.4	ACTATTTTTAGACTTCCCCACCCCGCAGTTTCAAGG	23	21	15	13	8	er	independent
seq2422_all_clean_seqs_gap0_no20_0.4	CAACCTGCTATAAGGAAGTTAAACCGCAGCTCACCG	24	22	14	13	10	er	ambiguous
seq2424_all_clean_seqs_gap0_no20_0.4	ACCCTTCCTGGAGCATTGTCGCAGCAACCACAACAG	28	26	6	4	22	er	cooperative
seq2425_all_clean_seqs_gap0_no20_0.4	CTCTTCAGCAGGAAATGATGTGGTAAAACAGGGTTA	21	19	11	10	10	er	cooperative
seq2428_all_clean_seqs_gap0_no20_0.4	ACATTTCCTTTTGGTATTTAAAGTAACCACACAGAA	27	25	6	4	21	er	cooperative
seq2429_all_clean_seqs_gap0_no20_0.4	TTCTTCCGGCAACTGCTGCTGAGGCTGCGGTGGCGG	28	26	5	3	23	er	cooperative
seq242_all_clean_seqs_gap0_no20_0.4	TTAGATGTGCCTACATCCTGACCTCAAAAACCTCTG	22	20	16	14	6	er	independent
seq2430_all_clean_seqs_gap0_no20_0.4	ACAGGAAATGACTTAGGGAAAGTCCCAACCGCAATC	29	27	4	3	25	er	independent
seq2434_all_clean_seqs_gap0_no20_0.4	TCTTGTTTCTTCCGTTACCGGAGCGCGGTCACGTGA	26	24	11	9	15	er	cooperative
seq2435_all_clean_seqs_gap0_no20_0.4	CGTGGCGGAAGCCGCGGGGACTGCGGGGGCGGAGTG	24	22	7	6	17	er	independent
seq2436_all_clean_seqs_gap0_no20_0.4	ATTCCTAGAGAGGAAATGCGGGCTCAGGGTGTCGGC	19	17	12	11	7	er	ambiguous
seq2437_all_clean_seqs_gap0_no20_0.4	GGCAGCCGATGCATCCTGCGGTGTGTGGCCCTCAGA	19	17	14	12	5	er	cooperative
seq2438_all_clean_seqs_gap0_no20_0.4	GAGTACAGGAAATGCAAAGTAAAACCACAGTGAGAT	25	23	8	7	17	er	cooperative
seq2439_all_clean_seqs_gap0_no20_0.4	AAACTACACCTCAGAGGATGTGGTTCCTTCTCTCAT	21	19	16	15	5	er	ambiguous
seq2440_all_clean_seqs_gap0_no20_0.4	AGCTCCACCGGAAACGGCCTGGCCGCAGCCAATCAG	23	21	10	9	13	er	cooperative
seq2441_all_clean_seqs_gap0_no20_0.4	AGGGAAGCAGGAAGTGACTGCGGGAGTGGAGCCGGC	21	19	10	9	11	er	cooperative
seq2442_all_clean_seqs_gap0_no20_0.4	GCAGGGGCCCATTTCCTGCCACAAGCCCACACAGGA	19	17	14	12	5	er	cooperative
seq2445_all_clean_seqs_gap0_no20_0.4	GCACTTCCGGAGCCGGGCGTCTACAGACCGCGGCCA	28	26	6	4	22	er	cooperative
seq2447_all_clean_seqs_gap0_no20_0.4	GCGGGAAAAGGGAAGTTTGCGGGAGGTCAAATCCAC	20	18	11	10	9	er	independent
seq2451_all_clean_seqs_gap0_no20_0.4	TCAGAGACTTCCGCTCAGCAGCAGCTGCGGCCAGGC	28	26	10	8	18	er	cooperative
seq2452_all_clean_seqs_gap0_no20_0.4	TGCCTCCTCGTCACAGGATGTGGTCGCTGCACCCTG	21	19	16	15	5	er	cooperative
seq2454_all_clean_seqs_gap0_no20_0.4	GCTGGGCCATCCTGCCACATGCACCGCATCTCTGGG	24	22	10	8	14	er	independent
seq2455_all_clean_seqs_gap0_no20_0.4	CGAAACGCGTTCCCCGGAAACCGCGCCCGGCTCCGA	21	19	16	15	5	er	cooperative
seq2456_all_clean_seqs_gap0_no20_0.4	ACACAGGAAGGACGCACGCTCCCGCCCCAACCACAT	31	29	6	5	25	er	cooperative
seq2457_all_clean_seqs_gap0_no20_0.4	GCACCGTCTACCCGGAAGTTGTGGGCTGGGAGGGAT	22	20	14	13	8	er	cooperative
seq2458_all_clean_seqs_gap0_no20_0.4	TGCAGTCGTGAAAAAGGAAGTGGTTAAAGTGGATAC	21	19	16	15	5	er	cooperative
seq2459_all_clean_seqs_gap0_no20_0.4	GTGCAGACAGGAAATAGCTGCTCTGCGGCAGCCCGA	26	24	10	9	16	er	cooperative
seq2460_all_clean_seqs_gap0_no20_0.4	TGCCCTGACTTCCTGGTCCTGTGGTCAAGGATGGGG	22	20	11	9	11	er	cooperative
seq2464_all_clean_seqs_gap0_no20_0.4	CCGGGCGCCACTTCCGGTCCCCGTGGTCACGTGACC	24	22	13	11	11	er	cooperative
seq2465_all_clean_seqs_gap0_no20_0.4	CTACTTTCCGGTCAACGCGGCCTGCGGTACCACCTC	25	23	7	5	18	er	cooperative
seq2468_all_clean_seqs_gap0_no20_0.4	GTGGGGAGAGGCAGGAAACCGCTGCCGCCGACGGGG	19	17	14	13	5	er	cooperative
seq246_all_clean_seqs_gap0_no20_0.4	TTCATAAAGGAGAGGAAACCTGACCACGACAGAAAG	24	22	14	13	10	er	independent
seq2470_all_clean_seqs_gap0_no20_0.4	GGACGCTTCCGGTGGAAGGGAGCTGTTGCGGGGCTT	29	27	8	6	21	er	cooperative
seq2472_all_clean_seqs_gap0_no20_0.4	TGCCGCGGATACCCAGCCAGCGGCAGTGCGGTTAAC	29	27	7	6	22	er	independent
seq2473_all_clean_seqs_gap0_no20_0.4	GATACCCAGCCAGCGGAAGTGCGGTTAACTGCCCGA	22	20	15	14	7	er	cooperative
seq2474_all_clean_seqs_gap0_no20_0.4	ACCGGCCGAGCCAACTTCCGGCCGCAGAGGCTGCCG	22	20	17	15	5	er	cooperative
seq2476_all_clean_seqs_gap0_no20_0.4	GTGCAGGGCCCGGAAGCTCAGTGTGGTTAAAGACAT	24	22	12	11	12	er	cooperative
seq2477_all_clean_seqs_gap0_no20_0.4	TTCTATCCTGCCTTGCATGTCTTTAACCACACTGAG	27	25	6	4	21	er	independent
seq2478_all_clean_seqs_gap0_no20_0.4	CTGGTTTCCAACATCCTGTGGGCGGCCTGGTTTCAG	19	17	14	12	5	er	cooperative
seq2479_all_clean_seqs_gap0_no20_0.4	GTGACGGATATCCACCGGGCCCTGTGGTTTCCAACA	25	23	6	5	19	er	cooperative
seq247_all_clean_seqs_gap0_no20_0.4	GTGTTTCCTCTTTGTTTTGGGGCTGTGGTTGCCACA	26	24	6	4	20	er	cooperative
seq2480_all_clean_seqs_gap0_no20_0.4	CACCCATAGCACCCCGGAAACCACCTCCACCACCTG	21	19	16	15	5	er	cooperative
seq2482_all_clean_seqs_gap0_no20_0.4	ATGTACATAGATACAGGATGTGGGTTTGTTACAAAG	21	19	16	15	5	er	cooperative
seq2484_all_clean_seqs_gap0_no20_0.4	GAAATGAAGGCCGGATGTCAGTAACCACAAACGAGC	25	23	13	12	12	er	cooperative
seq2485_all_clean_seqs_gap0_no20_0.4	GTTCTTATCCTGTGGCTCGTTTGTGGTTACTGACAT	24	22	8	6	16	er	independent
seq2486_all_clean_seqs_gap0_no20_0.4	TGTCGTACATTTCCGCCTTGTGGGCACAATCTGATT	21	19	12	10	9	er	cooperative
seq2487_all_clean_seqs_gap0_no20_0.4	GTACGACAGCGGGTTCCGGTGACCACGAAGGCGGCA	23	21	15	13	8	er	cooperative
seq2489_all_clean_seqs_gap0_no20_0.4	TACAGCCAGGAAATGGGGAGGGTGCTGCGGGCGGCA	28	26	9	8	19	er	cooperative
seq2490_all_clean_seqs_gap0_no20_0.4	GGGTCGCGGCCTTCCGGCGAACGCGGTTACCGTGGA	24	22	13	11	11	er	cooperative
seq2491_all_clean_seqs_gap0_no20_0.4	AATCTGAAACAGGAAATAAGTCTGTGGTTGTGTGTT	25	23	12	11	13	er	cooperative
seq2492_all_clean_seqs_gap0_no20_0.4	CTCTGAACTTCCTCTCTTTTAACCACAACTTACTAC	23	21	10	8	13	er	independent
seq2493_all_clean_seqs_gap0_no20_0.4	GGCCTTCATTACACAGGATGCGGTTGAAATGCATCA	21	19	16	15	5	er	cooperative
seq2494_all_clean_seqs_gap0_no20_0.4	GGCAGGAAAGAGCTGATGCATTTCAACCGCAGCCTG	27	25	5	4	22	er	independent
seq2495_all_clean_seqs_gap0_no20_0.4	GACAGGAAGCCCGCGGCAGCCTCCGTGGTTGCAGAT	26	24	5	4	21	er	cooperative
seq2496_all_clean_seqs_gap0_no20_0.4	CGGGGATGGGATTTCCGGTGGTTTTTCTTCACTTTC	19	17	14	12	5	er	cooperative
seq2497_all_clean_seqs_gap0_no20_0.4	GGAGGAAGAGGAGGATGTGGTGAGCCGCTCCCCGCC	18	16	13	12	5	er	cooperative
seq2498_all_clean_seqs_gap0_no20_0.4	TGGCTGCCACTGAGAGGATGTGGTGACAGAGGTGGG	21	19	16	15	5	er	cooperative
seq2499_all_clean_seqs_gap0_no20_0.4	GCACTCATTTCCTGTCCCCTGTGGTTTAAAGGTTTT	22	20	10	8	12	er	cooperative
seq24_all_clean_seqs_gap0_no20_0.4	CTGGGGATGTGTGACACTCAGAGAAACCACAAGGTG	27	25	5	4	22	er	independent
seq2501_all_clean_seqs_gap0_no20_0.4	AGGTACCAGGCCCGGAAACCACGGAAAGGGGAACTT	19	17	14	13	5	er	cooperative
seq2502_all_clean_seqs_gap0_no20_0.4	GCTTACACTTCCTCCCTGAACCCCTGCGGTTTCACA	27	25	10	8	17	er	cooperative
seq2503_all_clean_seqs_gap0_no20_0.4	AGCGCCGGAAGTGTGTCTGCGTAAAACTGCGGCTCG	30	28	7	6	23	er	cooperative
seq2504_all_clean_seqs_gap0_no20_0.4	ACTACAACTTCCGACTTGCATCACTGCGGTGGCGCT	27	25	10	8	17	er	cooperative
seq2505_all_clean_seqs_gap0_no20_0.4	ACTGAACAAACCGGATGTGGTTGCCACCTGCAATCT	18	16	13	12	5	er	cooperative
seq2507_all_clean_seqs_gap0_no20_0.4	GCGCGGCCCGGAAGGGGGTAACCGCTGAGTCTTTGA	22	20	10	9	12	er	cooperative
seq2508_all_clean_seqs_gap0_no20_0.4	AGGGTTGGGGAGGATGTTGTGGTTATTATTGACATA	20	18	12	11	8	er	ambiguous
seq2509_all_clean_seqs_gap0_no20_0.4	GGACTCTGGCAGGAAGCTGTTTGTGGTTGTCACACC	24	22	12	11	12	er	cooperative
seq2510_all_clean_seqs_gap0_no20_0.4	CTGCCTTTCCTGCTAGGGTACAAACCACAGCCTTAG	25	23	8	6	17	er	independent
seq2513_all_clean_seqs_gap0_no20_0.4	CTGCGAGCTCAGAACGGAAACCACAGCAACTACCGT	21	19	16	15	5	er	cooperative
seq2518_all_clean_seqs_gap0_no20_0.4	TGCGCCGGAAGTGCATGAGCTGCCGATGTGGTGCTT	29	27	7	6	22	er	cooperative
seq2521_all_clean_seqs_gap0_no20_0.4	CGGCCTCTTCCGGTCACCTGGCCCGTCGCGGTCCCG	29	27	9	7	20	er	cooperative
seq2523_all_clean_seqs_gap0_no20_0.4	TTCTCATCCGGCCGGCTTGCTTTCCCCTGCGGTCGT	30	28	7	5	23	er	cooperative
seq2524_all_clean_seqs_gap0_no20_0.4	TGGGCAGGAAGTGGTATCTGATTGTGGTTTTGATTT	25	23	7	6	18	er	cooperative
seq2526_all_clean_seqs_gap0_no20_0.4	TCATGCTGCTTCCTGCCCAACCCGCAGTTCCGATAA	22	20	11	9	11	er	cooperative
seq2528_all_clean_seqs_gap0_no20_0.4	GAAGGTTGTAGAGGAAGTGGTTTGTTCTTCCTCCTG	18	16	13	12	5	er	cooperative
seq2529_all_clean_seqs_gap0_no20_0.4	TCCTAAAGCAGGAAATAGTGAGGCTACCGCAGTGTC	27	25	11	10	16	er	cooperative
seq252_all_clean_seqs_gap0_no20_0.4	CTAACCCTGCTTCCTCTTAGTGGTTTCCCCCAACCT	21	19	12	10	9	er	cooperative
seq2531_all_clean_seqs_gap0_no20_0.4	TTCATCTCTCACTTCCTGTGGTGACGGCTGACGGGG	19	17	14	12	5	er	cooperative
seq2533_all_clean_seqs_gap0_no20_0.4	CCCAGCCGAGGGAGGAAGCCTGCGGTCACTGCCATC	23	21	14	13	9	er	ambiguous
seq2536_all_clean_seqs_gap0_no20_0.4	TGCAATTGGCAGACAGGAAACCGCGGCGTTTTCTGG	21	19	16	15	5	er	cooperative
seq2537_all_clean_seqs_gap0_no20_0.4	GCGCCCTCCAGGAAACGCCGCGGTTTACTGTCTGCC	21	19	11	10	10	er	cooperative
seq253_all_clean_seqs_gap0_no20_0.4	GGGGAAAGGAAGAGGAAACCGCGAGTGCAAAGGCCC	19	17	14	13	5	er	cooperative
seq2546_all_clean_seqs_gap0_no20_0.4	AGCCCGCCGGAAACTAGCGTCACCGCGCCAAGGTTC	23	21	9	8	14	er	cooperative
seq2550_all_clean_seqs_gap0_no20_0.4	CGAGCTCGGTGTTCCGCTTTTTGTGGGCCGGGTGGG	24	22	13	11	11	er	independent
seq2551_all_clean_seqs_gap0_no20_0.4	TGCCTCACCTCACATCCGTTTGTGGCTGCCGAGTGC	23	21	15	13	8	er	cooperative
seq2553_all_clean_seqs_gap0_no20_0.4	CCCATTTCCTGCTCTCCAGAGTTAACCACTGAAGTC	26	24	7	5	19	er	cooperative
seq2554_all_clean_seqs_gap0_no20_0.4	CCTCGGTTCGGAAACGGCGAAAGCAAACCGCAAGGA	28	26	10	9	18	er	independent
seq2555_all_clean_seqs_gap0_no20_0.4	CGCCGGCTCCCGGATGTTGTGGGGATCAGCGCCCGC	20	18	12	11	8	er	cooperative
seq2556_all_clean_seqs_gap0_no20_0.4	ACAAGAGGAAGTGAGTCTACCCATGATGCGGTCACA	29	27	7	6	22	er	cooperative
seq2557_all_clean_seqs_gap0_no20_0.4	CACTTCCGGGTCGTCAGCTCAGTTCTGCGGTTTCTG	28	26	5	3	23	er	cooperative
seq2558_all_clean_seqs_gap0_no20_0.4	TGGAGTGGAGGAAGTGGTGTTACCACAGCTCAGAGG	23	21	10	9	13	er	cooperative
seq255_all_clean_seqs_gap0_no20_0.4	GATGGTGTCTTTTGGGGATGTGGGTTTGGGGGATGG	21	19	16	15	5	er	cooperative
seq2560_all_clean_seqs_gap0_no20_0.4	ATCTTGGCCCATATCCTGTGGTGTTCTGCTAGAGGT	19	17	14	12	5	er	cooperative
seq2561_all_clean_seqs_gap0_no20_0.4	CTCTTCCTGCCTGTCCGTGGCTGGTGTGGTTTGCGT	27	25	5	3	22	er	cooperative
seq2562_all_clean_seqs_gap0_no20_0.4	GCTGAGGCCGGAAGAGGGTGGGGCCGCGGTGGCTAG	27	25	10	9	17	er	cooperative
seq2565_all_clean_seqs_gap0_no20_0.4	TGCTTAGCAGGAAGTTAGTCTGCCTGTGGTAGCTCC	27	25	10	9	17	er	ambiguous
seq2566_all_clean_seqs_gap0_no20_0.4	CACCTCAGCTTCCTGTGTAGCTGGGACCACAGGCAT	27	25	11	9	16	er	cooperative
seq2567_all_clean_seqs_gap0_no20_0.4	ACTCACTTCCGTTTAGCTTATCAACCACCAAGAGAC	25	23	8	6	17	er	cooperative
seq256_all_clean_seqs_gap0_no20_0.4	AGCGGCTGCACAGGAAGTTGGTTTTCACAAAGGCAA	19	17	13	12	6	er	cooperative
seq2570_all_clean_seqs_gap0_no20_0.4	GTGCCCCGGACCTACGGATACCACACACAGACAGGC	21	19	16	15	5	er	independent
seq2571_all_clean_seqs_gap0_no20_0.4	CTGCGCGGCCGGAAGTCGGCGGTTTCCCAGACGACG	20	18	11	10	9	er	cooperative
seq2572_all_clean_seqs_gap0_no20_0.4	GGCCCTTCTGGGGCAGGATGTGGTGCCTGCCAAAGG	21	19	16	15	5	er	cooperative
seq2573_all_clean_seqs_gap0_no20_0.4	TCACTCTAACAGGATATTGTGGTTAACTATGTTGCC	20	18	12	11	8	er	cooperative
seq2574_all_clean_seqs_gap0_no20_0.4	AGCTCTGCCAGGAAGTGAGAACCACAGGCCTCCCCT	22	20	11	10	11	er	cooperative
seq2575_all_clean_seqs_gap0_no20_0.4	CCCCTTAGCACAGGATGTGGTCTTTGCATCTTCATT	18	16	13	12	5	er	cooperative
seq2577_all_clean_seqs_gap0_no20_0.4	GGAATTTCTTTTTCCGGTCCCGCAGGGTCAGCTGAG	20	18	13	11	7	er	cooperative
seq2578_all_clean_seqs_gap0_no20_0.4	TGACATGGCTTCCGCCTTGGGCTTTGTGGTCTCCCA	27	25	11	9	16	er	cooperative
seq2579_all_clean_seqs_gap0_no20_0.4	GGGCAGGCCGGATGTGGGAGACCACAAAGCCCAAGG	22	20	10	9	12	er	cooperative
seq2581_all_clean_seqs_gap0_no20_0.4	GGACTTCCTGAACTGGGAGGTCACCGACCACAACCT	28	26	6	4	22	er	cooperative
seq2583_all_clean_seqs_gap0_no20_0.4	CCAATGGGCAGGCGGAAACCGCGGGCTCGTGCTCCC	19	17	14	13	5	er	cooperative
seq2584_all_clean_seqs_gap0_no20_0.4	GACAGCAACTCCACTTCCTGTGGGCGAGGGCCCTGT	21	19	16	14	5	er	cooperative
seq2585_all_clean_seqs_gap0_no20_0.4	GAGGACGCGGAAGTCCTTCTTGCGGGGCGGAGCTAG	23	21	9	8	14	er	independent
seq2586_all_clean_seqs_gap0_no20_0.4	TTAACTCCACGGAAGAATAAACCACCACCGCTCACC	22	20	11	10	11	er	independent
seq2587_all_clean_seqs_gap0_no20_0.4	GGAACAGGAAAAGCCTCCGGCAGCCCCTGCGGGCGG	30	28	7	6	23	er	cooperative
seq2588_all_clean_seqs_gap0_no20_0.4	ACATGGTCTCGCTTCCTGTTTACACCACAGAAAGCT	25	23	14	12	11	er	cooperative
seq2589_all_clean_seqs_gap0_no20_0.4	CAGCTCTCTCGCTTCCTGTGGTGTAAACATGAAGCA	19	17	14	12	5	er	cooperative
seq258_all_clean_seqs_gap0_no20_0.4	TTTTATCCTTCCTTTTTTGTTCTTTGTGGTGGAGGT	27	25	10	8	17	er	independent
seq2591_all_clean_seqs_gap0_no20_0.4	GACAAAGAGGAAGTCCCCAAAAACCACAATAACAGT	24	22	9	8	15	er	cooperative
seq2594_all_clean_seqs_gap0_no20_0.4	CTCCGCCAGCCACCGGAACTGCGGCCCAGCAAAAAG	22	20	15	14	7	er	ambiguous
seq2595_all_clean_seqs_gap0_no20_0.4	CCCCTACTTCCCTTTTTGCTGGGCCGCAGTTTCGGT	24	22	9	7	15	er	cooperative
seq2597_all_clean_seqs_gap0_no20_0.4	GGGTGCAGACGGGAAGTTGCGGCTGCCAGCGAAGCT	20	18	12	11	8	er	cooperative
seq2599_all_clean_seqs_gap0_no20_0.4	ACCAACCGGAAGTGATCGTGTTGTGGCCGAAGGAGG	24	22	8	7	16	er	cooperative
seq259_all_clean_seqs_gap0_no20_0.4	AGTTGGTTCCTTCCGGTGGGTTTGTGGGTTTGGGGT	25	23	12	10	13	er	cooperative
seq2601_all_clean_seqs_gap0_no20_0.4	TGGTTTCCGGGCTGGGGTTAGAATAGGCCACAAGGT	28	26	6	4	22	er	cooperative
seq2603_all_clean_seqs_gap0_no20_0.4	AACAGAGACCCGGAAGTTGTGGGACGAAGCCAGGAC	20	18	12	11	8	er	cooperative
seq2604_all_clean_seqs_gap0_no20_0.4	CCCCTCGCCCTTCCGCATTGCGGGTTACTTCGGTTG	21	19	12	10	9	er	independent
seq2606_all_clean_seqs_gap0_no20_0.4	AAATCACGTACCCGGAAACCACATGCACAGAAGTGG	19	17	14	13	5	er	cooperative
seq2607_all_clean_seqs_gap0_no20_0.4	CCCTGGGGCCCCACTTCCTTGCCCACAAGAAAGGAC	23	21	16	14	7	er	cooperative
seq2608_all_clean_seqs_gap0_no20_0.4	CGGCTAGGAAATAAAGAGCCTTCTCTCCGCGGTAGG	30	28	7	6	23	er	independent
seq2609_all_clean_seqs_gap0_no20_0.4	TTTCCACTTCCTGTTCTACTTGTGGCTACTGACTCA	23	21	9	7	14	er	cooperative
seq2611_all_clean_seqs_gap0_no20_0.4	TATGGGGCCGGAAGCCATTCACCACAAACACTGTGT	22	20	10	9	12	er	cooperative
seq2612_all_clean_seqs_gap0_no20_0.4	GCAAACAGCACATCCGGTGTGGTCGACGGGTCCTCC	20	18	13	11	7	er	cooperative
seq2613_all_clean_seqs_gap0_no20_0.4	CAAAAGTGCTTCCTCTCGAGGGGTTGTGGTTCTTAC	27	25	11	9	16	er	cooperative
seq2614_all_clean_seqs_gap0_no20_0.4	GTCCCCGACTTCCGCTCTCGGTTGGTGGTTGGCTTT	26	24	11	9	15	er	cooperative
seq2622_all_clean_seqs_gap0_no20_0.4	GTGGTCGGGAGGGGAAGTGAGGCGGTTACCTCGGCG	23	21	13	12	10	er	ambiguous
seq2623_all_clean_seqs_gap0_no20_0.4	GCTGCCGGAAAAGGCGCCGAGGTAACCGCCTCACTT	26	24	7	6	19	er	ambiguous
seq2624_all_clean_seqs_gap0_no20_0.4	GTGGCTATGGGAAGTGGGGTGCGGTTTCTGCCGGGG	22	20	10	9	12	er	independent
seq2625_all_clean_seqs_gap0_no20_0.4	CCAGAGGGCGGAAGTGGGAGCTGCGACCGCGCTCCC	27	25	10	9	17	er	cooperative
seq2626_all_clean_seqs_gap0_no20_0.4	TCTGTTCTTCCTTTTCCTGTGCGGTGTGCCCCAAAC	22	20	15	13	7	er	independent
seq2627_all_clean_seqs_gap0_no20_0.4	CCCCTATATCACAGGATGCCGCAAACTAGTAACAGG	19	17	14	13	5	er	cooperative
seq2628_all_clean_seqs_gap0_no20_0.4	GTTTGAAGGGAAGTGGGTGTTGACCTGCGGGCAACT	28	26	9	8	19	er	independent
seq2629_all_clean_seqs_gap0_no20_0.4	ACCCGGATGTCGTTGGGCAGGAACTGCGGTGAGGGC	27	25	5	4	22	er	cooperative
seq262_all_clean_seqs_gap0_no20_0.4	AGCTAGACTACAGGAGGAAACCACAGCCTAAACCAG	21	19	16	15	5	er	independent
seq2630_all_clean_seqs_gap0_no20_0.4	TCCCACATCCTGTGCTCGTGCAGTGGTTAGGCTCAA	24	22	8	6	16	er	cooperative
seq2633_all_clean_seqs_gap0_no20_0.4	GGGTCTCCAGGAAGCCACTCACCACAAACTTTGACA	22	20	10	9	12	er	cooperative
seq2635_all_clean_seqs_gap0_no20_0.4	CCCCTGCCCCTTCCTGGAAGGCTGCGGTGTAACACC	25	23	12	10	13	er	cooperative
seq2636_all_clean_seqs_gap0_no20_0.4	GCTGTGCCGGCAGGATGTGGTCTTTGGTTTCTGTTT	18	16	13	12	5	er	cooperative
seq2638_all_clean_seqs_gap0_no20_0.4	CAGTGGCAGGAAGAGGTCAGAAACCACTCGTGGTGG	24	22	9	8	15	er	cooperative
seq2639_all_clean_seqs_gap0_no20_0.4	GCCTGTCGCAGGAACGGAAGTGGTTACGGCCCTAGT	21	19	16	15	5	er	cooperative
seq2641_all_clean_seqs_gap0_no20_0.4	AAGGTGGAAAAAGGATGTGGTTCTAAGCTGGCTTCT	18	16	13	12	5	er	cooperative
seq2643_all_clean_seqs_gap0_no20_0.4	TGAGGAGAGCGAGGAAGTGGTTTTCTCTTCGCACAG	18	16	13	12	5	er	cooperative
seq2644_all_clean_seqs_gap0_no20_0.4	CAACAACCGGAAGTGGGGCGGGCCGCAGTACCCGCC	23	21	9	8	14	er	cooperative
seq2645_all_clean_seqs_gap0_no20_0.4	GCCCGCCCCGGAAGTGCAAACTGTGTGGTCTGGCAG	26	24	10	9	16	er	cooperative
seq2646_all_clean_seqs_gap0_no20_0.4	GCCAGCGGGGCTTCCGGCCCCGCAGGCAGAAGTCGA	20	18	13	11	7	er	cooperative
seq2647_all_clean_seqs_gap0_no20_0.4	CCTTTCCGCGAGACCTTCCGCGGTTATCCAGCGAGT	21	19	17	15	4	er	cooperative
seq2648_all_clean_seqs_gap0_no20_0.4	AATGATTACCTAACAGGAAAACCACATTGGTCATTT	22	20	16	15	6	er	ambiguous
seq2649_all_clean_seqs_gap0_no20_0.4	CTTCATCAACCCATCCTGTCTTGTGGTTAAGTCAAG	24	22	14	12	10	er	independent
seq2650_all_clean_seqs_gap0_no20_0.4	AAAGCATTTCCTGCCTTGACTTAACCACAAGACAGG	25	23	9	7	16	er	cooperative
seq2651_all_clean_seqs_gap0_no20_0.4	CTTGCCACACTTCCTCTTGTTTTGAACCACTATATT	27	25	12	10	15	er	cooperative
seq2652_all_clean_seqs_gap0_no20_0.4	AAAAAGCCGGATGTGAAGGCTGTGGTTCTCAACCCG	23	21	9	8	14	er	cooperative
seq2655_all_clean_seqs_gap0_no20_0.4	TTCTGCTACATCCTGCCCACTCCCTGTGGCTTCCAC	27	25	11	9	16	er	cooperative
seq2656_all_clean_seqs_gap0_no20_0.4	ACCTTGCCTAGAGGAAGTGGTTTTTCGAATCTGAGT	18	16	13	12	5	er	cooperative
seq2657_all_clean_seqs_gap0_no20_0.4	GAGAAACAAACAGGATGTGGTCTCTGCCCTGGAGGA	18	16	13	12	5	er	cooperative
seq2658_all_clean_seqs_gap0_no20_0.4	GTTGCAGGAAACGATGGGTTTTGTGGTATGAACTGC	24	22	7	6	17	er	cooperative
seq2659_all_clean_seqs_gap0_no20_0.4	AGCCTGGCCTCGGCAGGATGTGGGTGTAGGTCATGC	21	19	16	15	5	er	cooperative
seq265_all_clean_seqs_gap0_no20_0.4	TCCAGGCATTTCCCCCATGTTGGCTCACCGCACTAT	28	26	11	9	17	er	independent
seq2660_all_clean_seqs_gap0_no20_0.4	GCCTGTGGAGTTGCAGGATGTGGTTGGCGAAAAGAA	21	19	16	15	5	er	cooperative
seq2661_all_clean_seqs_gap0_no20_0.4	ACGAGGTTGGCCTCATCCGGTGGTTTTCGCAGCACG	21	19	16	14	5	er	cooperative
seq2663_all_clean_seqs_gap0_no20_0.4	ACCTGAGCAGGAAGTAGCTGAGGTCGCGGTGCAGCA	27	25	10	9	17	er	cooperative
seq2665_all_clean_seqs_gap0_no20_0.4	CTGTGCGAGGCAGGATGTGGTCTCCCGCCACCAGGG	18	16	13	12	5	er	cooperative
seq2666_all_clean_seqs_gap0_no20_0.4	CCAGCTACACAGGATGCTGCGGTGGGCGGAATGCTC	20	18	12	11	8	er	cooperative
seq2668_all_clean_seqs_gap0_no20_0.4	CCGGGAAGGCGGAAGCAGCAGAGACGCCGCAAGGCC	27	25	11	10	16	er	ambiguous
seq266_all_clean_seqs_gap0_no20_0.4	GAAATCCATCACGGATGTGGGCTTTTTGCTCTCATT	18	16	13	12	5	er	cooperative
seq2670_all_clean_seqs_gap0_no20_0.4	TTTCTGACACTCTCAGGATGTGGGTTTTCACACTGT	21	19	16	15	5	er	cooperative
seq2671_all_clean_seqs_gap0_no20_0.4	TTTCTGACACTCTCAGGATGTGGGTTTTCGCACTGT	21	19	16	15	5	er	cooperative
seq2672_all_clean_seqs_gap0_no20_0.4	TTTCTGAAACCCTCAGGATGTGGGTTTTCACACTGT	21	19	16	15	5	er	cooperative
seq2673_all_clean_seqs_gap0_no20_0.4	GTCTTTCACTCCACTTCCGCCCCCACAAAACATACA	23	21	16	14	7	er	ambiguous
seq2676_all_clean_seqs_gap0_no20_0.4	CAGCTTTCCGGCCTGCAGCACAGGCAATGTGGTTTT	30	28	7	5	23	er	cooperative
seq2678_all_clean_seqs_gap0_no20_0.4	GCAGAGTTTACAACAGGATGTGGTTATTGGCGCTGC	21	19	16	15	5	er	cooperative
seq2679_all_clean_seqs_gap0_no20_0.4	CTCACAGAGCAAGTAGGATGTGGTTTCCAGGGGCTG	21	19	16	15	5	er	cooperative
seq267_all_clean_seqs_gap0_no20_0.4	CAGAGGAAGCCCACCCCATAAAAGAACCACAGATAA	27	25	5	4	22	er	independent
seq2681_all_clean_seqs_gap0_no20_0.4	GACAAAACACAGAAAGGAAGTGGTCAACTATTGCAC	21	19	16	15	5	er	cooperative
seq2682_all_clean_seqs_gap0_no20_0.4	CCTCACCCAGGAAGTGGCTGCGGCTGTCTCAGGGTT	21	19	10	9	11	er	cooperative
seq2683_all_clean_seqs_gap0_no20_0.4	TTGGCTTTGTGTTTCCGCGGTGTTGGTAGAGTCTCG	18	16	14	12	4	er	independent
seq2684_all_clean_seqs_gap0_no20_0.4	ACACAAACAGGAAGTGTTTGTGGTCCCTGCCTTTAG	21	19	10	9	11	er	cooperative
seq2685_all_clean_seqs_gap0_no20_0.4	GGAGAGTTGACTTCCGGCGGCTTGTGGGAGTGCTGG	25	23	13	11	12	er	cooperative
seq2686_all_clean_seqs_gap0_no20_0.4	AAAATTAAAGCAGGAAGTAATCAACCACATCAAATG	25	23	13	12	12	er	cooperative
seq2687_all_clean_seqs_gap0_no20_0.4	CCGTGGAAGGAAACGCTGCCAACCGCAACAGAAATG	23	21	9	8	14	er	cooperative
seq2689_all_clean_seqs_gap0_no20_0.4	AAGTGAAGAGCTTCCGCCGGGAGACCGCGGCTGCAG	25	23	13	11	12	er	cooperative
seq2692_all_clean_seqs_gap0_no20_0.4	GCAACAGCGATCCCCGGAAACCACAAGGCGAGATGT	21	19	16	15	5	er	cooperative
seq2694_all_clean_seqs_gap0_no20_0.4	CGAGTAGAGATAGCAGGAAGTGGTTTATTCTGAGGT	21	19	16	15	5	er	cooperative
seq2695_all_clean_seqs_gap0_no20_0.4	AGTTTCTTCTTTCCGGTGGGTTTGTGGTCTTGCTGA	25	23	12	10	13	er	cooperative
seq2699_all_clean_seqs_gap0_no20_0.4	CCAGCAAAGGAAGCTTGGTCAACCACAGCAGCCTGT	23	21	9	8	14	er	independent
seq269_all_clean_seqs_gap0_no20_0.4	CTTATCTTCTTCCTGTGAGCTGTGTGTGGGTGGCTC	27	25	11	9	16	er	cooperative
seq2700_all_clean_seqs_gap0_no20_0.4	CATGGGGAGGAGGAAGTGGTGGCGGCCGCAGGCCAG	26	24	12	11	14	er	cooperative
seq2702_all_clean_seqs_gap0_no20_0.4	GTTGTCTTCTTCCTGAGTAAACCGCAGTGCAGAGAA	22	20	11	9	11	er	independent
seq2703_all_clean_seqs_gap0_no20_0.4	CACTCCCCGAATCCGGTCTGCGGCGCGCTCGGGGCC	21	19	12	10	9	er	cooperative
seq2704_all_clean_seqs_gap0_no20_0.4	GCCCAATTCCCGAATCCGGTCTGCGGCGCGCTCGGG	24	22	15	13	9	er	cooperative
seq2705_all_clean_seqs_gap0_no20_0.4	CTACGACTTCCGTGATGCCTTGCGGTTGCTGTAGCC	23	21	9	7	14	er	cooperative
seq2707_all_clean_seqs_gap0_no20_0.4	CTAAACCGGAAGCCGCCCCTCTGACCGCTCTAAAAC	25	23	8	7	17	er	cooperative
seq2708_all_clean_seqs_gap0_no20_0.4	ACAGACCAGGGGATTTCCTGTGGGTGGAGTCCTCAG	21	19	16	14	5	er	cooperative
seq2709_all_clean_seqs_gap0_no20_0.4	CTTGGCGGAAGTGGTGTGGGGGAGGTAGCCCGCAGT	30	28	7	6	23	er	cooperative
seq2710_all_clean_seqs_gap0_no20_0.4	TCAATGACAGGAAGTTTTTAAACCACATACGGCTAA	23	21	10	9	13	er	cooperative
seq2712_all_clean_seqs_gap0_no20_0.4	TGCAGCTATGGCCGGAAGCCTGTGGGTGTGGGAGGA	23	21	14	13	9	er	cooperative
seq2714_all_clean_seqs_gap0_no20_0.4	TATGTGTTTTAGGCAGGATGTGGGTTTTAGTCTTTC	21	19	16	15	5	er	cooperative
seq2715_all_clean_seqs_gap0_no20_0.4	GGCAGCAAGAAAGGAAATAGTGTGGTTGGGTGGAGA	23	21	13	12	10	er	cooperative
seq2717_all_clean_seqs_gap0_no20_0.4	TGCGACGGAAGCAGGAACTTGCTAACCACAAAACCC	26	24	7	6	19	er	cooperative
seq2718_all_clean_seqs_gap0_no20_0.4	AGGTCTCCGGAAGTGGGTCTGCGGCGCGCGGGATGC	22	20	9	8	13	er	cooperative
seq2719_all_clean_seqs_gap0_no20_0.4	GTCTGCTTAAAAACAGGAAACCACATATCTCCACCC	21	19	16	15	5	er	cooperative
seq2720_all_clean_seqs_gap0_no20_0.4	TCCCCCACTTCCTGGCAGCAGCAGTGTGGTGAGGAG	27	25	10	8	17	er	cooperative
seq2722_all_clean_seqs_gap0_no20_0.4	CAGGTGTTCAGGAAACAAAACCACAGACTTTTTCAC	21	19	11	10	10	er	independent
seq2723_all_clean_seqs_gap0_no20_0.4	ATCTTTTGATGAGGATGTGGTTTCCAGGCAGGTGCT	18	16	13	12	5	er	cooperative
seq2724_all_clean_seqs_gap0_no20_0.4	CCTTCCTTCCTGCTGTGTACGTTGTGGTCACAGCAC	25	23	8	6	17	er	cooperative
seq2725_all_clean_seqs_gap0_no20_0.4	CTCCCGGACGCTAACGTCTGGCAAACCACATTGCCC	26	24	6	5	20	er	ambiguous
seq2726_all_clean_seqs_gap0_no20_0.4	AATGCAGCATTTCCTCTCCAGTTCACCACAGGCCCC	26	24	12	10	14	er	cooperative
seq2729_all_clean_seqs_gap0_no20_0.4	CTCGCGATTCCTCTTCCGCTGCGGTCTCCTTAACAC	22	20	15	13	7	er	cooperative
seq272_all_clean_seqs_gap0_no20_0.4	TGGGAACTTCCTGTGGAGGAGTGCATTGTGGGACTT	29	27	9	7	20	er	cooperative
seq2730_all_clean_seqs_gap0_no20_0.4	CACTTCCTCCTCGGGGGCCTCAGAAAACCACAGGGC	28	26	5	3	23	er	cooperative
seq2733_all_clean_seqs_gap0_no20_0.4	AACTCCTGGCCGGAACGGCACAGACCGCACTCCCGC	25	23	12	11	13	er	independent
seq2734_all_clean_seqs_gap0_no20_0.4	GAGTTCCGCCTCGCCGTTTGTCCCTTGCGGTACCCG	28	26	5	3	23	er	cooperative
seq2735_all_clean_seqs_gap0_no20_0.4	GCGCAAAGCCGGAAGGAGGGGTTTGCGGCTGGGGAG	26	24	11	10	15	er	cooperative
seq2736_all_clean_seqs_gap0_no20_0.4	CTTCGACCCCGGAAGCGCTAACCACCCCGGGGGCCG	22	20	11	10	11	er	cooperative
seq2738_all_clean_seqs_gap0_no20_0.4	TGGGGACAGGAAATGTTTACTGCCTGTGGCTTGCTG	27	25	9	8	18	er	cooperative
seq2739_all_clean_seqs_gap0_no20_0.4	TTGGAAACAGACAGGAAGCCACAGGCAGTAAACATT	19	17	14	13	5	er	ambiguous
seq2741_all_clean_seqs_gap0_no20_0.4	CCCGCTCACGCCGGAAGTGGTTTGCGTTTTCAAGAT	18	16	13	12	5	er	cooperative
seq2742_all_clean_seqs_gap0_no20_0.4	GTGGTCTCTCCCGGAAAAACCACTTCCACCGAGAAC	20	18	13	12	7	er	cooperative
seq2743_all_clean_seqs_gap0_no20_0.4	CGGTGGCTTCCGGCCCATGGCGGTGGTTGGTGACTC	24	22	9	7	15	er	cooperative
seq2745_all_clean_seqs_gap0_no20_0.4	CGAACGCCGGACGTTCTGGGCACGTGACCGCCACCC	28	26	9	8	19	er	independent
seq2746_all_clean_seqs_gap0_no20_0.4	CCCACCCAGGAAGCCGTCCTAACCACAACAGCCCTC	23	21	9	8	14	er	independent
seq2747_all_clean_seqs_gap0_no20_0.4	GGACCCAGCAGAGGATGTGGTTACAGGGCCATGATA	18	16	13	12	5	er	cooperative
seq2748_all_clean_seqs_gap0_no20_0.4	ACAATAACAGGAAGTGGTGGGGACTGCGGTGACCTG	27	25	10	9	17	er	cooperative
seq2749_all_clean_seqs_gap0_no20_0.4	GTCACAGGAAAGAAGGAGCCTCGCCTTAACCGCACC	30	28	7	6	23	er	independent
seq2752_all_clean_seqs_gap0_no20_0.4	GACACAAGCCTCACAGGATGTGGTCAAAGAAGGTTG	21	19	16	15	5	er	cooperative
seq2753_all_clean_seqs_gap0_no20_0.4	GGTAAAGCAACAGGATGTGGGTGTCTGACTTACAAT	18	16	13	12	5	er	cooperative
seq2755_all_clean_seqs_gap0_no20_0.4	GGATGACATCCGGCACCAACTTAACCACTAATCTCA	25	23	9	7	16	er	cooperative
seq2756_all_clean_seqs_gap0_no20_0.4	CAGCTAGCCGGAAGAAGCTGCGGCGACAGCGTCCTG	21	19	10	9	11	er	cooperative
seq2757_all_clean_seqs_gap0_no20_0.4	AACCCACCGGATGGAAGCTGCCACTCAGCCGCAGGA	29	27	9	8	20	er	ambiguous
seq2758_all_clean_seqs_gap0_no20_0.4	CTGGGCGTGGGCTTCCTGCGGCTGAGTGGCAGCTTC	19	17	14	12	5	er	cooperative
seq2759_all_clean_seqs_gap0_no20_0.4	CCCGGAGGACGTCCGGCCTCTGTGAGCCGCAACCTT	27	25	12	10	15	er	cooperative
seq2760_all_clean_seqs_gap0_no20_0.4	GTTTCATGTTAAGTAGGATGTGGTCAGTTAGCTTCG	21	19	16	15	5	er	independent
seq2761_all_clean_seqs_gap0_no20_0.4	GCGAAAGGAACTTCCTTTGCATGCGGTCAGAGTGCT	24	22	13	11	11	er	cooperative
seq2763_all_clean_seqs_gap0_no20_0.4	GGCCTCGGCCACATCCGGGTTCCACCGCAGATTCGG	25	23	14	12	11	er	cooperative
seq2765_all_clean_seqs_gap0_no20_0.4	GTGTGGAAGGAGGAAGCGAGAATGTGGTTACTTAGG	25	23	12	11	13	er	independent
seq2766_all_clean_seqs_gap0_no20_0.4	ATTTTAGCATTTTCCTGCTCGGAGACCACATGTTTG	26	24	13	11	13	er	independent
seq2767_all_clean_seqs_gap0_no20_0.4	TGAGTCACATCCTGCAGGGCTGCGGTATCCTGGCTT	23	21	10	8	13	er	cooperative
seq2768_all_clean_seqs_gap0_no20_0.4	TGTCCGCACCCCACTTCCGCCCCGCAGAGGGCAACG	22	20	16	14	6	er	cooperative
seq2769_all_clean_seqs_gap0_no20_0.4	GGAGGCGGAAGTGGAGGTTGTTGTGGCTCCGAGGGC	24	22	7	6	17	er	cooperative
seq2774_all_clean_seqs_gap0_no20_0.4	CGATGCTTCCGGCCTCCTATTGGGTGGTTTCTTGGC	25	23	8	6	17	er	cooperative
seq2775_all_clean_seqs_gap0_no20_0.4	AGCCACATCCTGGACAAAAGCTGTGGTCTAGTAACC	24	22	8	6	16	er	cooperative
seq2776_all_clean_seqs_gap0_no20_0.4	GAAGCGGAAGTCGCTGAGGGGTGGTGAAGCGGTTGG	30	28	6	5	24	er	cooperative
seq2777_all_clean_seqs_gap0_no20_0.4	AGGTTCTCCAGAGGAGGAAGTGGTTTGCTGCAGGCT	21	19	16	15	5	er	cooperative
seq2778_all_clean_seqs_gap0_no20_0.4	CCCTTCGCTTCCGCTCCGCGTTCCCACAATGCAGTG	24	22	10	8	14	er	cooperative
seq2779_all_clean_seqs_gap0_no20_0.4	CCCGGCCCAGGAAACTTCAGACTTCACCGCAGCTTC	27	25	10	9	17	er	ambiguous
seq2780_all_clean_seqs_gap0_no20_0.4	CCTCTGAGGCAGGAAGCTGCGGTGAAGTCTGAAGTT	20	18	12	11	8	er	cooperative
seq2781_all_clean_seqs_gap0_no20_0.4	TGACATCCTCTGAGGCAGCAAGCTGCGGTGAAGTCT	26	24	6	4	20	er	cooperative
seq2783_all_clean_seqs_gap0_no20_0.4	ATTGCTTCCGACGCTACTCCTGCCGGGTCACCACAG	31	29	7	5	24	er	cooperative
seq2785_all_clean_seqs_gap0_no20_0.4	AACTAAGTGCAGGGGAAGTTGTGGTTATTTTTTACC	22	20	14	13	8	er	independent
seq2787_all_clean_seqs_gap0_no20_0.4	CCAACGAGCACTTCCGCTTCCCGCAGCTCCAGCGGC	21	19	13	11	8	er	cooperative
seq2788_all_clean_seqs_gap0_no20_0.4	CAGGCAGGATGTTGACTCAGCTGCCAAGTGGTTTTG	29	27	7	6	22	er	cooperative
seq2789_all_clean_seqs_gap0_no20_0.4	TGGATGGCAAGCAACGGAAACCGCAAACAGGGCTGT	21	19	16	15	5	er	independent
seq278_all_clean_seqs_gap0_no20_0.4	TTTATCATGAATGCAGGATGTGGGCAAACTCATGAC	21	19	16	15	5	er	cooperative
seq334_all_clean_seqs_gap0_no20_0.4	TTTATCATGAATGCAGGATGTGGGCAAACTCATGAC	21	19	16	15	5	er	cooperative
seq2795_all_clean_seqs_gap0_no20_0.4	GGGCCCGGGCCAGGAAGTGGTTTTGCAGAGGTGTTT	18	16	13	12	5	er	cooperative
seq2796_all_clean_seqs_gap0_no20_0.4	CCTGCGGATCACGGAAGTGGCTGCGGTCGGCGCCAT	24	22	13	12	11	er	cooperative
seq2799_all_clean_seqs_gap0_no20_0.4	TTGCTCCCGGAAGCCCCGCCCGACCGCGGCTCCTGA	24	22	9	8	15	er	cooperative
seq27_all_clean_seqs_gap0_no20_0.4	GAGGGCCTGGGAGGAAGTGGGTTTTGCATACAGTCC	18	16	13	12	5	er	cooperative
seq2800_all_clean_seqs_gap0_no20_0.4	GCGAAAAACGCGGAAATGCGGTGGCGGCGGCCCGCT	19	17	12	11	7	er	cooperative
seq2801_all_clean_seqs_gap0_no20_0.4	CTTGCTTAACGCTTCCTGAGGGGTGGTTTGGGTTTT	24	22	14	12	10	er	independent
seq2804_all_clean_seqs_gap0_no20_0.4	TCCAGGATGTGGGATGCCGTGCTGTACCGCATGTCA	27	25	5	4	22	er	cooperative
seq2805_all_clean_seqs_gap0_no20_0.4	CCGGTCCTGACCGGAAGCGGTAACCGTCACTCCTTC	18	16	13	12	5	er	cooperative
seq2806_all_clean_seqs_gap0_no20_0.4	GGCACTTCCGGTCCTGACCTGAAGCGGTAACCGTCA	25	23	7	5	18	er	cooperative
seq2808_all_clean_seqs_gap0_no20_0.4	ACAGATACAGCCTCAGGAAGTGGTTTTGTATCTCTG	21	19	16	15	5	er	cooperative
seq2809_all_clean_seqs_gap0_no20_0.4	CTACAAACGGCTTCCTCCTGCCTAACCACAACCTCA	26	24	13	11	13	er	independent
seq2810_all_clean_seqs_gap0_no20_0.4	GAAGCTCCCCAAACAGGATGTGGTTAGGGAGAGGGG	21	19	16	15	5	er	cooperative
seq2812_all_clean_seqs_gap0_no20_0.4	TGCAGCCTATTTCCTCTAACCCGCAGATCCACTATG	21	19	12	10	9	er	cooperative
seq2813_all_clean_seqs_gap0_no20_0.4	AGCCTTAATTACCCGGAAGTGCGGTCCCAGGGACTT	22	20	15	14	7	er	cooperative
seq2814_all_clean_seqs_gap0_no20_0.4	GGCGGTGACCGGAAGAGCTGAGTCACCGCAGGCGAC	26	24	11	10	15	er	cooperative
seq2816_all_clean_seqs_gap0_no20_0.4	CCCACTGCGCCAGGATGTGGTCAGGTCGGTGACGTT	18	16	13	12	5	er	cooperative
seq2819_all_clean_seqs_gap0_no20_0.4	TGGGCAAGATATCCTGGAAGTGGTTAAAAAAAATTA	21	19	12	10	9	er	cooperative
seq2820_all_clean_seqs_gap0_no20_0.4	TACGTCACTTCCGGGCCGCCGTCCTGCGGGCAAGGG	27	25	10	8	17	er	cooperative
seq2822_all_clean_seqs_gap0_no20_0.4	AGAAGGCGCCGGAAGTGGTCCCGCAGAGGCGGGGTG	21	19	11	10	10	er	cooperative
seq2823_all_clean_seqs_gap0_no20_0.4	CAGAGGACAGGATGCCAACCCCAAAACCGCAGCGAC	27	25	10	9	17	er	independent
seq2825_all_clean_seqs_gap0_no20_0.4	AGCACAAACCCAGGATGTGGTAAATGAAATGAAAAA	18	16	13	12	5	er	cooperative
seq2827_all_clean_seqs_gap0_no20_0.4	CAGCTGCTGACAGGAAAACCACAGTGGAAGGGGAAG	19	17	13	12	6	er	cooperative
seq2828_all_clean_seqs_gap0_no20_0.4	AGTGGCAGTGCAGGAAGTGGTTTGTCTGGTACAATC	18	16	13	12	5	er	cooperative
seq2830_all_clean_seqs_gap0_no20_0.4	GGCTCGGCAAACATCCGGCTCCGCGGTGGAACGGGA	24	22	14	12	10	er	cooperative
seq2831_all_clean_seqs_gap0_no20_0.4	CCGGGTAGGATCCGGTTGCCTTTCTGCGGTGGAGGA	27	25	11	9	16	er	cooperative
seq2832_all_clean_seqs_gap0_no20_0.4	AATCCAACACTTCCTCCTCCACCGCAGAAAGGCAAC	22	20	12	10	10	er	cooperative
seq2833_all_clean_seqs_gap0_no20_0.4	TGAGAAAACAGGAAGCGCCCAGTCACCACAGAAAGC	26	24	11	10	15	er	cooperative
seq2835_all_clean_seqs_gap0_no20_0.4	AGCACTTCCGTTTGGGCAGGGCTGCGGGCCGGAGGG	25	23	7	5	18	er	cooperative
seq2836_all_clean_seqs_gap0_no20_0.4	GTTGAGTTCCGGGGGAGGTTGAGTTCCTGCGGTCAA	30	28	8	6	22	er	cooperative
seq2837_all_clean_seqs_gap0_no20_0.4	GCAGCCCAGCTTCCTGCAGACCAAAACCACAAGCAG	27	25	12	10	15	er	cooperative
seq2838_all_clean_seqs_gap0_no20_0.4	ACCCCGGAAGTGTGGGCGCGGCTGCGGTTTAACCCG	25	23	6	5	19	er	cooperative
seq2841_all_clean_seqs_gap0_no20_0.4	GGGATCTACTTCCTCTCTCGGCCGCGGCCGCAGCAC	28	26	11	9	17	er	cooperative
seq2842_all_clean_seqs_gap0_no20_0.4	CCCCTCAGCTTCCGGGTGCTGCGGCCGCGGCCGAGA	22	20	11	9	11	er	cooperative
seq2844_all_clean_seqs_gap0_no20_0.4	TTGATTGGAGCAGGATGTGGTCAGAACAGTATGCAG	18	16	13	12	5	er	cooperative
seq2845_all_clean_seqs_gap0_no20_0.4	TGGGGAGGCAGGAAACGGGCCTTGTGGTTGGGGGGT	25	23	11	10	14	er	ambiguous
seq2846_all_clean_seqs_gap0_no20_0.4	CACGGAGCCACTTCCGGCGGCTGTGGGCGCAAAACC	24	22	13	11	11	er	cooperative
seq2850_all_clean_seqs_gap0_no20_0.4	CGGGAGGGGCAGGAAGCGGACTGCGGTGGGGAAGGG	24	22	12	11	12	er	cooperative
seq2851_all_clean_seqs_gap0_no20_0.4	AACAGCACACAGGAAGTTACCGCTGAAGCAAAGGAG	20	18	12	11	8	er	cooperative
seq2855_all_clean_seqs_gap0_no20_0.4	GTGGGGCGGGCTTCCGGCGCTCCCACCGCGAGCCGA	26	24	13	11	13	er	cooperative
seq2856_all_clean_seqs_gap0_no20_0.4	TGGCTGTGTCCCGGAAGTGGTCATAAGCTGGGTCCC	18	16	13	12	5	er	cooperative
seq2858_all_clean_seqs_gap0_no20_0.4	AAAGGCGGAAGGGGGGCAGGGAACCCACAAAACAGA	25	23	7	6	18	er	independent
seq2860_all_clean_seqs_gap0_no20_0.4	CCCGGCCACTTCCGCCTATTGCGGGCGTCGGCTAGG	22	20	11	9	11	er	cooperative
seq2861_all_clean_seqs_gap0_no20_0.4	TGGGGGATGGCAGCAGGATGTGGTTATCTCAGAAAG	21	19	16	15	5	er	cooperative
seq2862_all_clean_seqs_gap0_no20_0.4	GGGCCCTTCCTGTGGCGCCTGCCGAGCTGTGGTTGG	30	28	8	6	22	er	cooperative
seq2863_all_clean_seqs_gap0_no20_0.4	CTCCAGGGACAACCCGGAAACCACATTGCCCAGCGT	21	19	16	15	5	er	cooperative
seq2864_all_clean_seqs_gap0_no20_0.4	AGCAGCTGCCAGAGGAAGTCTGCGGTCGGAACAGGC	23	21	14	13	9	er	independent
seq2865_all_clean_seqs_gap0_no20_0.4	CTCAGGAATGCGGAAGTGCTCTGTGGGCACCCACCA	24	22	12	11	12	er	cooperative
seq2866_all_clean_seqs_gap0_no20_0.4	TTAACCAGACATTTCCTGTGGTCTAAGGTGACCCCA	19	17	14	12	5	er	cooperative
seq2867_all_clean_seqs_gap0_no20_0.4	ACACCCCAGGCAGGATGTGGTAGGGGTTGCCCCAGA	18	16	13	12	5	er	cooperative
seq286_all_clean_seqs_gap0_no20_0.4	ACCATCCTGTAGTCTGTTAAGTGAGCAACCGCATTA	29	27	5	3	24	er	cooperative
seq2870_all_clean_seqs_gap0_no20_0.4	GCTAGACAGGAAACAGTGAGCTTCTGTGGGCAGGAG	27	25	9	8	18	er	cooperative
seq2871_all_clean_seqs_gap0_no20_0.4	TCTGATGTGCCTTCTTCCTGACCACAGCAACTACTA	22	20	16	14	6	er	independent
seq2872_all_clean_seqs_gap0_no20_0.4	ACCCCAAGCCCAGGATGTGGTTTGGCCACTATTGAG	18	16	13	12	5	er	cooperative
seq2873_all_clean_seqs_gap0_no20_0.4	CCTTGCTGCAGGATGCTCTAACCACAAGCCCAGGAG	22	20	11	10	11	er	independent
seq2874_all_clean_seqs_gap0_no20_0.4	CAACGGCGTAGCCGGAAGTCAGTGGTTTTCGCCCCA	23	21	14	13	9	er	cooperative
seq2875_all_clean_seqs_gap0_no20_0.4	TGTGCTGACTACAGGATGCTGTGGTTAGTCAGGTTG	22	20	14	13	8	er	cooperative
seq2878_all_clean_seqs_gap0_no20_0.4	ACTTTCGCGACGCAGGAAGCGCCCACAAAGGGAGGA	23	21	15	14	8	er	cooperative
seq2880_all_clean_seqs_gap0_no20_0.4	CACTGATTAAGAGGAAGTGTGTGTGGTTATTACCGT	24	22	13	12	11	er	cooperative
seq2881_all_clean_seqs_gap0_no20_0.4	GAAGAGAAAGGAAACGGCTCGCGGTTTCTGGGGTTC	22	20	10	9	12	er	cooperative
seq2882_all_clean_seqs_gap0_no20_0.4	GCTGGTATGGCAGGAAGTTTCTCACCACAGTATACT	25	23	13	12	12	er	cooperative
seq2883_all_clean_seqs_gap0_no20_0.4	GTTGCCCCACTTCCTGCCAGTGGTTTTTGGTTGGCC	21	19	12	10	9	er	cooperative
seq2884_all_clean_seqs_gap0_no20_0.4	GTTATTCTCCCCTTCCTGTGGTGTGTTTTGATGGTA	19	17	14	12	5	er	independent
seq2885_all_clean_seqs_gap0_no20_0.4	AGCCTACATCCTGCACTGCTTAACCACAGCCCGCCT	24	22	9	7	15	er	cooperative
seq2886_all_clean_seqs_gap0_no20_0.4	AGAACCACTTCCTCTCAGTAAACCACAGAGACTGTA	23	21	10	8	13	er	cooperative
seq2887_all_clean_seqs_gap0_no20_0.4	CGAGCAGGAAGTGGCAAGATTTGATAGGCGGTCAGG	29	27	7	6	22	er	cooperative
seq2888_all_clean_seqs_gap0_no20_0.4	CCTCGCCCCCTTCCGCACCCACCCCACCGCGCTCCG	27	25	12	10	15	er	ambiguous
seq2889_all_clean_seqs_gap0_no20_0.4	AAGAAAAAGGGAGGATGTGGTTTAGCAAAAGCACTG	18	16	13	12	5	er	cooperative
seq2890_all_clean_seqs_gap0_no20_0.4	GAGTGACTGCTAACGGATGTGTGGTTTCTTTAGTTT	22	20	15	14	7	er	cooperative
seq2891_all_clean_seqs_gap0_no20_0.4	TAACTACTTCCTTTTACTATCTACCACAATTTAATT	24	22	9	7	15	er	cooperative
seq2893_all_clean_seqs_gap0_no20_0.4	ATCATCTAGGAGACAGGATGTGGTTAGGGTGTTAAA	21	19	16	15	5	er	cooperative
seq2894_all_clean_seqs_gap0_no20_0.4	TTAGCACATCCTGGGTACACAGACCACAGCCTCCTC	24	22	9	7	15	er	cooperative
seq2895_all_clean_seqs_gap0_no20_0.4	AGGAAACCACAAGTTATTCCCTGCAAAGGTCTTGAT	7	5	-999	-999	1006	er	ambiguous
seq2896_all_clean_seqs_gap0_no20_0.4	ACCATAAGGACCGGAAGCAGAGACCACACTGGTGCT	24	22	13	12	11	er	cooperative
seq2898_all_clean_seqs_gap0_no20_0.4	GAAATGAGAGAACGGAAACCACAAGTCAAGGGGCTT	19	17	14	13	5	er	independent
seq2899_all_clean_seqs_gap0_no20_0.4	CGTTCTCTCATTTCCTGTGTGCACCCACATGAACCA	25	23	13	11	12	er	cooperative
seq2901_all_clean_seqs_gap0_no20_0.4	ACTTTAATAGAGTCCGGATGCGGTTAGGCTGACAGA	21	19	16	15	5	er	cooperative
seq2902_all_clean_seqs_gap0_no20_0.4	TCTAACGCTGAAGGAGGATGTGGTTTCCTATTGGAC	21	19	16	15	5	er	cooperative
seq2903_all_clean_seqs_gap0_no20_0.4	TGCACGGTAAGCAGGAAGCTGCGGCCGAGCTGAGTC	22	20	14	13	8	er	cooperative
seq2904_all_clean_seqs_gap0_no20_0.4	GTTTCCACTTCCTGCTGTGCAGCAGTACCACCAAGA	28	26	10	8	18	er	cooperative
seq2905_all_clean_seqs_gap0_no20_0.4	AAGTGGAGAGCGGAAGTGAGCTGTGGGTGACTGCAG	24	22	12	11	12	er	cooperative
seq2906_all_clean_seqs_gap0_no20_0.4	TCTGGGACAGGAAAGACTTGTGGTTACTGCTGTTGA	21	19	10	9	11	er	cooperative
seq2907_all_clean_seqs_gap0_no20_0.4	AGCCGTCATTCAGGATGTGGTGACAGACATGGAGAC	18	16	13	12	5	er	cooperative
seq2909_all_clean_seqs_gap0_no20_0.4	CTAGGCCACCGGAAGTCTCCGCAGTGGTTTTGCAAA	25	23	11	10	14	er	cooperative
seq290_all_clean_seqs_gap0_no20_0.4	TTACGTTAAGGAGGAAACTCTGTGGTTAAACTGTAG	23	21	13	12	10	er	ambiguous
seq2913_all_clean_seqs_gap0_no20_0.4	GGGGACCGGAAAGGGAGGGGTGGGCCGCAGGCGCCG	25	23	8	7	17	er	cooperative
seq2914_all_clean_seqs_gap0_no20_0.4	AGATTAGATGCAGGATGTGGTATACAAAGGCACGTT	18	16	13	12	5	er	cooperative
seq2915_all_clean_seqs_gap0_no20_0.4	ATGGCGAAGCAGGATGCCCTCAACCCACATACGGCA	25	23	12	11	13	er	independent
seq2916_all_clean_seqs_gap0_no20_0.4	TCACATTTTGCCGGATGTGGGTTGAGGGCATGCTGC	18	16	13	12	5	er	cooperative
seq2917_all_clean_seqs_gap0_no20_0.4	CACCTCACAGCCCGGATACAAACCGCCTACCCGCCC	23	21	14	13	9	er	independent
seq2918_all_clean_seqs_gap0_no20_0.4	AACAGTACTTCCGGGGCAAGTGAGCGCCCACAAGGC	28	26	10	8	18	er	cooperative
seq291_all_clean_seqs_gap0_no20_0.4	CCAACTTTTGAGGGATGTGGTTACGTTTTCTAGATC	18	16	13	12	5	er	independent
seq2922_all_clean_seqs_gap0_no20_0.4	ATGTCCCCAGGAGGATGTGGTGTGTCCACAGGAGGA	18	16	13	12	5	er	ambiguous
seq2923_all_clean_seqs_gap0_no20_0.4	GAATGGCGGATGTGGCTGGGGAGAGAAAGCCGCAGA	30	28	8	7	22	er	cooperative
seq2924_all_clean_seqs_gap0_no20_0.4	TGGGGCTAGGCTTCCGGGGCTCTGCGGTCCTCGGCC	25	23	13	11	12	er	cooperative
seq2926_all_clean_seqs_gap0_no20_0.4	GGAGGGGCTGGCCGGAAGTGAACCGCAGAGCACGCT	23	21	14	13	9	er	cooperative
seq2927_all_clean_seqs_gap0_no20_0.4	GCCACATATTTCCTGTGACAACCCTGTGGTGTGGCT	27	25	11	9	16	er	cooperative
seq2928_all_clean_seqs_gap0_no20_0.4	TTGAATATGAAAGGAAGTGGTTAGGTGATGTGTTCT	18	16	13	12	5	er	cooperative
seq2929_all_clean_seqs_gap0_no20_0.4	GCGAGAGGGAGGAAGTGACTCACCAACCACAACAAA	27	25	11	10	16	er	cooperative
seq292_all_clean_seqs_gap0_no20_0.4	TTGGTGACCTCTTCCTGTCCGCTGTGGTGTTGTTAC	25	23	13	11	12	er	cooperative
seq2930_all_clean_seqs_gap0_no20_0.4	CTTCTACTTCCTGCCCCGCCCCCAGCTGTGGTCACA	29	27	9	7	20	er	cooperative
seq2931_all_clean_seqs_gap0_no20_0.4	ATTTCGCTGAAAACAGGAAACCACGAAGCCCAGATG	21	19	16	15	5	er	cooperative
seq2935_all_clean_seqs_gap0_no20_0.4	CAGGGCACCTCCTACTTCCCCCCGCAGATAACTACC	22	20	17	15	5	er	independent
seq2936_all_clean_seqs_gap0_no20_0.4	CCTGGGCAAGGCCGGATGCCTGTGGCTTCCAGGCTG	23	21	14	13	9	er	cooperative
seq2937_all_clean_seqs_gap0_no20_0.4	GGACTTCCTGAAGCCAGATCGGTTTACCACAGTCAG	27	25	6	4	21	er	cooperative
seq2938_all_clean_seqs_gap0_no20_0.4	CCGCTGAGAACAGGATGTGGGTGTCAGGAGGTGAAG	18	16	13	12	5	er	cooperative
seq2939_all_clean_seqs_gap0_no20_0.4	AGCGCTTCCTGGCTCCGGCCCCGCCCCTGCGGTCGG	30	28	7	5	23	er	cooperative
seq293_all_clean_seqs_gap0_no20_0.4	GAGCCTGTTGCTTCCGGTTCAGAGCCCACATGCTGG	26	24	13	11	13	er	cooperative
seq2940_all_clean_seqs_gap0_no20_0.4	TGGTTTCTCACTGGCGGATGTGGGTGGGTCGCCTCC	21	19	16	15	5	er	cooperative
seq2941_all_clean_seqs_gap0_no20_0.4	TTGCTTTATCACTTCCTGTTTGAGGTTTATATCCAT	23	21	14	12	9	er	cooperative
seq2942_all_clean_seqs_gap0_no20_0.4	CAAAGGTTAAATGCAGGATGTGGTTTCTGCAGACTC	21	19	16	15	5	er	cooperative
seq2945_all_clean_seqs_gap0_no20_0.4	GCGCAAGCAGGAAGCGTTTGCGGTGATCCCGGCGAC	21	19	10	9	11	er	cooperative
seq2947_all_clean_seqs_gap0_no20_0.4	CCGCTTCCGGGACGCGAATCGCTCTGCGGCTGCGTC	27	25	6	4	21	er	cooperative
seq2948_all_clean_seqs_gap0_no20_0.4	TCTCTATGGTTTCCGTTGGGTGTGTGGTTTTTTTGT	25	23	12	10	13	er	cooperative
seq294_all_clean_seqs_gap0_no20_0.4	CATGGTGGTGACGCAGGATGTGGTGGTGGTGTAGAA	21	19	16	15	5	er	cooperative
seq2950_all_clean_seqs_gap0_no20_0.4	TCCCCTTTCCGGGAAGGGTTGGGGATCTGACCACGT	31	29	8	6	23	er	cooperative
seq2951_all_clean_seqs_gap0_no20_0.4	GCTTCTTCCGGCCGGGCCGAGAGGTGGTTACATTCG	25	23	7	5	18	er	cooperative
seq2952_all_clean_seqs_gap0_no20_0.4	ACCCTACTTCCGTTGCTGTGTTGCGGAGGTGACCTA	24	22	9	7	15	er	cooperative
seq2955_all_clean_seqs_gap0_no20_0.4	AGGTCGCCCTCCGGATGCGGTCCCCACACCGCCTGC	18	16	13	12	5	er	cooperative
seq2956_all_clean_seqs_gap0_no20_0.4	GCCCCGGAAGCTCCTTAAGGAGGACCGTGTGGGTTT	30	28	6	5	24	er	ambiguous
seq2958_all_clean_seqs_gap0_no20_0.4	GCTCTGGGTCACACAGGATGTGGTTTTTGAAGTTTG	21	19	16	15	5	er	cooperative
seq2959_all_clean_seqs_gap0_no20_0.4	CCACCACTCTAAGCAGGATGCGGTGCGACCCAAGAG	21	19	16	15	5	er	cooperative
seq295_all_clean_seqs_gap0_no20_0.4	TGGGGTGGTGACATGGGATGTGGTTTTGGGGTTGCA	21	19	16	15	5	er	ambiguous
seq2962_all_clean_seqs_gap0_no20_0.4	CTCCTGTTCCGGCTCAAAGGGAAACCGCTGCTTTTC	25	23	8	6	17	er	cooperative
seq2963_all_clean_seqs_gap0_no20_0.4	CAAGTAATCTGCTCAGGAAGTGGTTTGAATAGAGGA	21	19	16	15	5	er	cooperative
seq2964_all_clean_seqs_gap0_no20_0.4	TCCTGGCAGAGACCGGAAGTGCGGTCCGCGGAGCGT	22	20	15	14	7	er	cooperative
seq2967_all_clean_seqs_gap0_no20_0.4	AACAGACAGGATGTGGCCTCTGCCAAAACCACCATC	29	27	9	8	20	er	cooperative
seq2968_all_clean_seqs_gap0_no20_0.4	GTTGGGTGGGGAAGTGGATGGTGGTTTTGGCAGAGG	22	20	10	9	12	er	cooperative
seq2969_all_clean_seqs_gap0_no20_0.4	CCTGTTTCCTGCCATCTGCCCTTCCTTTGTGGTCAA	30	28	7	5	23	er	cooperative
seq2971_all_clean_seqs_gap0_no20_0.4	AGCCGCCACTTCCTGTCTCTGCGGGTGCATGCTCTT	22	20	11	9	11	er	cooperative
seq2972_all_clean_seqs_gap0_no20_0.4	TCGCCCACTTCCCCACCTCTCAAAAGACCACAGGCA	28	26	10	8	18	er	independent
seq2973_all_clean_seqs_gap0_no20_0.4	GGTTGTAAGTTCACAGGATGTGGTGTGTCCCTGTGG	21	19	16	15	5	er	cooperative
seq2974_all_clean_seqs_gap0_no20_0.4	CTCCATCTGCCCGGAAAACCGCAGCCGCCCCAACCT	19	17	13	12	6	er	independent
seq2975_all_clean_seqs_gap0_no20_0.4	AGGACCGGAAGTGCCCGAGGGCGGCCGCAGAACGGT	25	23	7	6	18	er	cooperative
seq2976_all_clean_seqs_gap0_no20_0.4	GGTCCGGAAACGATTCTGGACCTGCGGGTATATCCA	25	23	6	5	19	er	cooperative
seq2977_all_clean_seqs_gap0_no20_0.4	TCTTGCCCGGGTCGGAAATGGTGGTCACGAGCGCTT	22	20	14	13	8	er	independent
seq2978_all_clean_seqs_gap0_no20_0.4	GCTGACCCGGAAGCGCTCGTGACCACCATCTCCGAC	23	21	9	8	14	er	cooperative
seq2979_all_clean_seqs_gap0_no20_0.4	TCTGCCGCCAGCCCATCCGCGACCGCATCCAGATCT	23	21	16	14	7	er	ambiguous
seq297_all_clean_seqs_gap0_no20_0.4	ATCTTCAGGAAGCGGTATCAACCTGAAAACCACCAC	30	28	8	7	22	er	cooperative
seq2980_all_clean_seqs_gap0_no20_0.4	ACAAGGACTTCCGCCTCCCTGCGGTCCCTCCCCTAC	22	20	10	8	12	er	cooperative
seq2981_all_clean_seqs_gap0_no20_0.4	AAAACAAGGACTTCCGCCTCCCTGCGGTCCCTCCCC	25	23	13	11	12	er	cooperative
seq2982_all_clean_seqs_gap0_no20_0.4	GCGGGGCGCAGGAAGCGGGGCGAAACCACTGTTGGC	26	24	11	10	15	er	cooperative
seq2983_all_clean_seqs_gap0_no20_0.4	CCCACCCGGAAATGAGCCAACAGTGGTTTCGCCCCG	24	22	8	7	16	er	cooperative
seq2985_all_clean_seqs_gap0_no20_0.4	GAGGAACCCAAAGTAGGATGTGGTTTTGCAATTGGA	21	19	16	15	5	er	cooperative
seq2986_all_clean_seqs_gap0_no20_0.4	GTTCTCCACATCCTGTTCCGTAGCTGTGGTGCACCG	27	25	11	9	16	er	cooperative
seq2988_all_clean_seqs_gap0_no20_0.4	TCAATAAGACAGGATGTTCTCCAACCGCATTAAGCT	25	23	12	11	13	er	cooperative
seq298_all_clean_seqs_gap0_no20_0.4	TTTTTAAGGTCAGGATGTGGGCACATCTAAGGGGCA	18	16	13	12	5	er	cooperative
seq2992_all_clean_seqs_gap0_no20_0.4	GAAATCACATCCTTTTGCAAAACCACAGGTGTTTTG	23	21	10	8	13	er	cooperative
seq2993_all_clean_seqs_gap0_no20_0.4	GGACCGGTGTCTGGCGGATGCGGTCGTGAAGATAGG	21	19	16	15	5	er	cooperative
seq2994_all_clean_seqs_gap0_no20_0.4	ACACCGGAAGCCCAACAGCATGCCGAGTAACCACCC	31	29	6	5	25	er	cooperative
seq2995_all_clean_seqs_gap0_no20_0.4	GAAGCCCAACAGGATGCCGAGTAACCACCCACTGAA	25	23	12	11	13	er	independent
seq2996_all_clean_seqs_gap0_no20_0.4	CAGACCAGCCCAGGAAACAAGGAACCACAAAGCCAC	25	23	13	12	12	er	cooperative
seq2999_all_clean_seqs_gap0_no20_0.4	CAGTGACAGGAAGTGGTTCAGCGGTTGTTTAGGGCT	22	20	9	8	13	er	cooperative
seq3000_all_clean_seqs_gap0_no20_0.4	ATTACAGGAAGTATGTCCTCCTCTGCCTAACCACTG	31	29	7	6	24	er	cooperative
seq3001_all_clean_seqs_gap0_no20_0.4	GAAACCCCATGGGCAGGATGTGGGTGAGCTGTCTGG	21	19	16	15	5	er	cooperative
seq3002_all_clean_seqs_gap0_no20_0.4	CAGTCAAGAGGAAATTATAAACCACTGCCTCTTTGA	22	20	10	9	12	er	independent
seq3003_all_clean_seqs_gap0_no20_0.4	GCCCTGACCCACATCCTGCCGCAGCCTGCTTGTCCT	19	17	14	12	5	er	cooperative
seq3004_all_clean_seqs_gap0_no20_0.4	TTGGTTGTTGCCAGAGGATGTGGGTTGGCGGGGGAG	21	19	16	15	5	er	ambiguous
seq3005_all_clean_seqs_gap0_no20_0.4	GTAAATAAAGAGGAAGTCCCTATGCGGGGGATGGGG	25	23	12	11	13	er	independent
seq3006_all_clean_seqs_gap0_no20_0.4	CACCTCGGGGGTTTCCGGTCCGTGGTTAGCTCCTTC	23	21	14	12	9	er	cooperative
seq3007_all_clean_seqs_gap0_no20_0.4	CCTCTGTTCTTCACAGGAAGCCACAGGCCTCCCCTG	21	19	16	15	5	er	ambiguous
seq3009_all_clean_seqs_gap0_no20_0.4	CTGTTTCCTGCCTTTGCTGTCTGTGACCGCATCAGT	27	25	6	4	21	er	cooperative
seq300_all_clean_seqs_gap0_no20_0.4	GTAGGGAAGACGGGATGTGGGTTTTCAGCCGTGGCC	18	16	13	12	5	er	cooperative
seq3013_all_clean_seqs_gap0_no20_0.4	CATTTCAGTCCAGGATGTGGGTGCACACACCGCTTC	18	16	13	12	5	er	cooperative
seq3014_all_clean_seqs_gap0_no20_0.4	GGCGCTAGGCTTCCGGATCGCGGTGGGCGGAGTTCA	21	19	12	10	9	er	cooperative
seq3015_all_clean_seqs_gap0_no20_0.4	CATGGGACCCGGAAGTGTGTGGTAAAGCGCCGGGGC	20	18	11	10	9	er	cooperative
seq3017_all_clean_seqs_gap0_no20_0.4	CCCTGCCATTTCCTGCCCAATACCGCGTATGCAACT	23	21	11	9	12	er	cooperative
seq3018_all_clean_seqs_gap0_no20_0.4	GACTCTTCCGGCCCAGAGCTTTCGGAGTGCGGTTGC	30	28	7	5	23	er	cooperative
seq3019_all_clean_seqs_gap0_no20_0.4	AGGCGGCAGGAAATGACCCCATCCCGCAGCCTGGGC	24	22	9	8	15	er	cooperative
seq3020_all_clean_seqs_gap0_no20_0.4	GAGTTGCTTCCGGCCGTGTTGGTGGTCTGAATTGAG	23	21	9	7	14	er	cooperative
seq3021_all_clean_seqs_gap0_no20_0.4	GTTCAGCGGACGGCTTCCTGCGGCTTGCTGGGGCCG	21	19	16	14	5	er	cooperative
seq3022_all_clean_seqs_gap0_no20_0.4	TGGAAGCGGCTTCCGGGGTGAATGCGGTTGGATCGT	25	23	12	10	13	er	cooperative
seq3023_all_clean_seqs_gap0_no20_0.4	TGCGCCGGGAGGAAGGGCTCCAAAACCACAGGGCGG	26	24	11	10	15	er	independent
seq3024_all_clean_seqs_gap0_no20_0.4	GCCGCGCGGAAGCCTCCGCCCTGTGGTTTTGGAGCC	24	22	8	7	16	er	cooperative
seq3027_all_clean_seqs_gap0_no20_0.4	CCAAAAACCCCAGGAGGATGTGGTGAGGAGGGAAGG	21	19	16	15	5	er	cooperative
seq3028_all_clean_seqs_gap0_no20_0.4	CCCGCCGGAAGGACGCGTCTGCGTCTCTGCGGCGAG	30	28	7	6	23	er	cooperative
seq3029_all_clean_seqs_gap0_no20_0.4	GCCCCCGGAAGCTGTCGCCCCGTGCGGTGTGTGCTG	25	23	7	6	18	er	cooperative
seq302_all_clean_seqs_gap0_no20_0.4	AATATACGGTGAGGATGTGGGCAAAAAACAAAGAGG	18	16	13	12	5	er	cooperative
seq3030_all_clean_seqs_gap0_no20_0.4	GCCATCCAGGAAGTACAGACTCCCTGACCGCACTGA	28	26	9	8	19	er	cooperative
seq3033_all_clean_seqs_gap0_no20_0.4	ACCGCCGGAAGTTTCTGCCGCGGCTTTGCGGGGACG	29	27	7	6	22	er	cooperative
seq3034_all_clean_seqs_gap0_no20_0.4	ACAGGCTGTCTGCTTCCGTCAGCGGTTATTCCCTTG	23	21	15	13	8	er	cooperative
seq3039_all_clean_seqs_gap0_no20_0.4	CAGTTTGCCCCGGATGTTGACCGCCTTGAAGTCGTA	21	19	12	11	9	er	cooperative
seq3040_all_clean_seqs_gap0_no20_0.4	CAGCCTTGCCGGAAGGCAGAGTTTGTGGTCAGACCG	26	24	11	10	15	er	cooperative
seq3041_all_clean_seqs_gap0_no20_0.4	TTACAGGGGCCGGAAGTGGCCTGCGGGCGGAGAAGT	24	22	12	11	12	er	cooperative
seq3043_all_clean_seqs_gap0_no20_0.4	CACCAGGACGCAACAGGAAACCACAAAGGCCTGAGA	21	19	16	15	5	er	ambiguous
seq3048_all_clean_seqs_gap0_no20_0.4	AATATCCTGTATGTCATGCTTAAAAAGCCACAAAAC	28	26	5	3	23	er	cooperative
seq3049_all_clean_seqs_gap0_no20_0.4	CAGGCACACATCCGGGAGCGGCCTGCGCCGCAAGGC	28	26	11	9	17	er	cooperative
seq3051_all_clean_seqs_gap0_no20_0.4	ATGAGCTATTTCCTGCCTTGTGGTCAGAGCCAGACT	21	19	11	9	10	er	cooperative
seq3053_all_clean_seqs_gap0_no20_0.4	CTCAGGGTACCAGGATGTGGTTTAGCTTAGGGGTGG	18	16	13	12	5	er	cooperative
seq3054_all_clean_seqs_gap0_no20_0.4	CCTCCCACCTTGGCAGGAAGCGGTTTATCAGATTAA	21	19	16	15	5	er	cooperative
seq3056_all_clean_seqs_gap0_no20_0.4	GAACCACTTCCCTGAAACCATTTACCACATAAATCT	25	23	9	7	16	er	independent
seq3057_all_clean_seqs_gap0_no20_0.4	CGAGGGAGCCGGAAAGATGGTGGTTACCAGATCTGC	21	19	11	10	10	er	cooperative
seq3059_all_clean_seqs_gap0_no20_0.4	AGGCTCATTTCCTGTTTTCATGTGGTTTAGAGAAAA	23	21	10	8	13	er	cooperative
seq3060_all_clean_seqs_gap0_no20_0.4	AGGTTAATACCCGGAACTACCACAACCGTCTTCCCT	20	18	13	12	7	er	independent
seq3061_all_clean_seqs_gap0_no20_0.4	CTCACTTCCCCGGCAGCTCCCTCGCCCCGACCGCAG	31	29	7	5	24	er	independent
seq3062_all_clean_seqs_gap0_no20_0.4	GAACCTGGGAGGCGGAAGTTGCGGTTAGCCGAGATC	22	20	14	13	8	er	cooperative
seq3064_all_clean_seqs_gap0_no20_0.4	TTACGACACTTCCGGCGACGCCCCGCAGCCTTCACC	23	21	11	9	12	er	cooperative
seq3066_all_clean_seqs_gap0_no20_0.4	CGGGACACAGGAAGCCGTTGTGGGGCCCCGGGGCCA	21	19	10	9	11	er	cooperative
seq3067_all_clean_seqs_gap0_no20_0.4	TGCTCAAATGCAGGATGTGGTCTGAGAGTTTCTCCT	18	16	13	12	5	er	cooperative
seq306_all_clean_seqs_gap0_no20_0.4	CTGAGTGAGACAGGATGTGGGCAGACCTCTAACACA	18	16	13	12	5	er	cooperative
seq3071_all_clean_seqs_gap0_no20_0.4	AGAGGCTTCCTGAGGAACTGGTGTGGTCAGGGGAGC	24	22	8	6	16	er	cooperative
seq3072_all_clean_seqs_gap0_no20_0.4	CTCTGGCAGGAAGCTCTGAGGGCTAAACCACAAAAA	28	26	9	8	19	er	cooperative
seq3074_all_clean_seqs_gap0_no20_0.4	AACGGACCCGGAAGGGGCAGGTCTTGTGGGCGGGTC	27	25	10	9	17	er	ambiguous
seq3075_all_clean_seqs_gap0_no20_0.4	CAAGAGAAAGGAAGTGGAAGCTCTTGTGGTCTGGAA	27	25	10	9	17	er	cooperative
seq3078_all_clean_seqs_gap0_no20_0.4	GAGGCGTTTCCGCCTCCTTTTCGCGGTTGCCTTCTC	24	22	9	7	15	er	cooperative
seq3080_all_clean_seqs_gap0_no20_0.4	GCTCTGCAGGATGTGGCTGTGACCGCAGTGAGGAGC	23	21	9	8	14	er	cooperative
seq3081_all_clean_seqs_gap0_no20_0.4	CCCGACTTCCGCCGCTGGTGGCCACCCGCAGGTAGT	26	24	8	6	18	er	cooperative
seq3082_all_clean_seqs_gap0_no20_0.4	CTTCAGCCGCCACTTCCCCGCCCCCGCAGCCCGACA	24	22	15	13	9	er	independent
seq3083_all_clean_seqs_gap0_no20_0.4	CTAGCTGTGGACAGGAAACGAGTGGTTTTTGTGATC	23	21	14	13	9	er	cooperative
seq3086_all_clean_seqs_gap0_no20_0.4	TCTCGTCCGGTCCTTGCTCCCCCTCCCCGCAGCGCT	27	25	6	4	21	er	cooperative
seq3087_all_clean_seqs_gap0_no20_0.4	TGGTTCCACCGACCGGAAGGGCCACAAGGATCCCCG	22	20	15	14	7	er	cooperative
seq3091_all_clean_seqs_gap0_no20_0.4	GCCCCCGGCTGGGCAGGATGTGGTGGCAGCTGCAGG	21	19	16	15	5	er	cooperative
seq3092_all_clean_seqs_gap0_no20_0.4	CCAAGTGTAAAACGGAAGCTCAACCACGAATCTTAC	24	22	14	13	10	er	cooperative
seq3093_all_clean_seqs_gap0_no20_0.4	CCCGGGGGCAGGAAATGTCGCCTTACCCACAGCCTT	27	25	11	10	16	er	cooperative
seq3094_all_clean_seqs_gap0_no20_0.4	TGTGTAACTTCCTGGCTTTGGTGGTTTCCCCCTCCT	22	20	10	8	12	er	cooperative
seq3096_all_clean_seqs_gap0_no20_0.4	CTGTGACACGTGCGGAAGCTGTGGTAAGTGCATCCA	22	20	14	13	8	er	cooperative
seq3098_all_clean_seqs_gap0_no20_0.4	CAGCACGCAGGAAGCACATGTGGTGGGGCTCTTCCA	21	19	10	9	11	er	cooperative
seq3099_all_clean_seqs_gap0_no20_0.4	GCTAAGAGCAGGAAATGATCTGGGAACCACCATCAC	27	25	11	10	16	er	cooperative
seq3100_all_clean_seqs_gap0_no20_0.4	ACCCACTTCCTGTTAGAGCATCTTTGCAACCACAGG	30	28	8	6	22	er	cooperative
seq3101_all_clean_seqs_gap0_no20_0.4	CGACTTCCGTCCCTGGGTGGGATCGAACCACCAACC	28	26	6	4	22	er	cooperative
seq3102_all_clean_seqs_gap0_no20_0.4	GAGCCCAACCGGCATCCGTCGCGGTTGGACGTGGGC	22	20	15	13	7	er	cooperative
seq3103_all_clean_seqs_gap0_no20_0.4	AGCTGCAGTTGGGCAGGAAACCACAATGTCGAAGAC	21	19	16	15	5	er	ambiguous
seq3104_all_clean_seqs_gap0_no20_0.4	AGTCAGCAGAGAGGAAGTGGTTAGTCCTGCCTTGAA	18	16	13	12	5	er	cooperative
seq3105_all_clean_seqs_gap0_no20_0.4	AAACCCTGAGTAATCGGAAGTGGTTAGGAGTGAGAG	21	19	16	15	5	er	cooperative
seq3108_all_clean_seqs_gap0_no20_0.4	AGCTGCATTTCCGGGCAGGCAATGAAACCACAGAGT	28	26	10	8	18	er	cooperative
seq3109_all_clean_seqs_gap0_no20_0.4	GCATTTACGGGCAGGAAATGAAACCACAGAGTACAA	24	22	14	13	10	er	cooperative
seq3111_all_clean_seqs_gap0_no20_0.4	CTGAGACATCCTGATAATTCTGTGGGTTACCCCAAA	23	21	9	7	14	er	cooperative
seq3113_all_clean_seqs_gap0_no20_0.4	GCCCCTAAACCGGATGCGGCAGCCACCGCGGACCCC	26	24	12	11	14	er	cooperative
seq3114_all_clean_seqs_gap0_no20_0.4	ATAGACTCAGGAAGTGATTGTGGTAAGATTCTATAT	21	19	10	9	11	er	cooperative
seq3115_all_clean_seqs_gap0_no20_0.4	GTATCACTTCCTGTTTTCCTCTGTGGCTTACTGCTG	24	22	9	7	15	er	cooperative
seq3116_all_clean_seqs_gap0_no20_0.4	AGCTTCCTGTTTGGCCTTGCTGATGTCACCGCATTA	29	27	5	3	24	er	cooperative
seq3117_all_clean_seqs_gap0_no20_0.4	TGTGTATGAGAACGGATATAGGTGGTTTTATAAGGA	23	21	14	13	9	er	cooperative
seq3119_all_clean_seqs_gap0_no20_0.4	CGGCTGTTTTCCAGGATGTTGTGGTCATGGCGGTGT	22	20	14	13	8	er	cooperative
seq3121_all_clean_seqs_gap0_no20_0.4	TGGCTGTGAGCTGCAGGATGTGGTCAGGAGAGGAAG	21	19	16	15	5	er	cooperative
seq3122_all_clean_seqs_gap0_no20_0.4	AGGCCTCGCTTCCTCTCCTGACCACACCCTGCAGCT	22	20	11	9	11	er	cooperative
seq3123_all_clean_seqs_gap0_no20_0.4	GAGGGGGAGGTTTCCGGGGCCTGTGGTTACTACACT	24	22	13	11	11	er	cooperative
seq3124_all_clean_seqs_gap0_no20_0.4	TCATAAGGAAGTGGAGTGTAGTAACCACAGGCCCCG	25	23	7	6	18	er	cooperative
seq3125_all_clean_seqs_gap0_no20_0.4	CATCCAGGACGGAAACAGCATCCCCACCGCGGGAGC	27	25	11	10	16	er	cooperative
seq3126_all_clean_seqs_gap0_no20_0.4	GGTTCTCTAGGGAGAGGATGTGGGTTTGTCTCTGGG	21	19	16	15	5	er	cooperative
seq3128_all_clean_seqs_gap0_no20_0.4	AGGCTGTGTGAAGGATGTGGTCAGGCGGAGGCCAGG	18	16	13	12	5	er	cooperative
seq3129_all_clean_seqs_gap0_no20_0.4	CTTCTGAGAGGAGGATGTGGTCAGATACCTACAAAT	18	16	13	12	5	er	cooperative
seq3130_all_clean_seqs_gap0_no20_0.4	GCAGAAGAGGAAATGGTTTGCCTGTGCGGTGGGGGA	27	25	9	8	18	er	cooperative
seq3132_all_clean_seqs_gap0_no20_0.4	CGTGTGGGAGGCCGGAAGTTGCGGCTTCATTACTCG	22	20	14	13	8	er	cooperative
seq3134_all_clean_seqs_gap0_no20_0.4	TTCACTTCCACCACTTCCTGTGGGTTTTGTTCATCC	21	19	16	14	5	er	cooperative
seq3135_all_clean_seqs_gap0_no20_0.4	CAGAACGGTCCCCGGAACACTGCGGTTCCCGCCTGG	23	21	14	13	9	er	independent
seq3136_all_clean_seqs_gap0_no20_0.4	ACTTCACTTCCCAACCTCCCCTGTGGTTAGGTGTGG	24	22	9	7	15	er	independent
seq3137_all_clean_seqs_gap0_no20_0.4	CTGGTAGAAAAGGAAGCAGGTTGTGGTGAGCATTTA	24	22	12	11	12	er	independent
seq3138_all_clean_seqs_gap0_no20_0.4	CTGAAACAGGAAACAGACAAAGCCACAAGGTTCGCA	23	21	9	8	14	er	cooperative
seq3139_all_clean_seqs_gap0_no20_0.4	AACATCCGGTTCCCGGTTCTGCCCCCTACCGCAGCT	29	27	5	3	24	er	cooperative
seq313_all_clean_seqs_gap0_no20_0.4	GCGGCGAACCGGACGCCCCAACCACCCGCCCCCCAC	22	20	11	10	11	er	ambiguous
seq3140_all_clean_seqs_gap0_no20_0.4	GACTGGACAACTTCCTGGTGGAAAACCGCGACTCTT	26	24	13	11	13	er	cooperative
seq3143_all_clean_seqs_gap0_no20_0.4	CAGAAAAGGCAGGAAGTGGTACAAACCACAAAAGGC	26	24	12	11	14	er	cooperative
seq3144_all_clean_seqs_gap0_no20_0.4	TTTGTGCCCCAACTTCCTCTGTGGCTTTTGGGTGGG	22	20	15	13	7	er	cooperative
seq3146_all_clean_seqs_gap0_no20_0.4	TGACGGCAGGCAGGATGTGGTGAGACAAATCCACTC	18	16	13	12	5	er	cooperative
seq3149_all_clean_seqs_gap0_no20_0.4	TGGAGAGCACAGGAAGTGGCCCACAGCCCAGGCCAA	21	19	12	11	9	er	cooperative
seq3150_all_clean_seqs_gap0_no20_0.4	ACCCAGGAGGCGGAAGTTGTGGTGAGCCGAGATCGC	20	18	12	11	8	er	cooperative
seq3152_all_clean_seqs_gap0_no20_0.4	TATCAATAAGGAAGTACAATCACCAAACCACAAGCC	28	26	10	9	18	er	independent
seq3153_all_clean_seqs_gap0_no20_0.4	GACCAGGCGAGAGGATGTGGGTATGAGGGAGGAGCT	18	16	13	12	5	er	cooperative
seq3154_all_clean_seqs_gap0_no20_0.4	TCGGCGGATATGAAAAAAAGTCCGTGGTCACGTGCA	25	23	6	5	19	er	independent
seq3155_all_clean_seqs_gap0_no20_0.4	TTTACAGGAAATTACAGGGGTTAAACCAAACCACAA	31	29	7	6	24	er	cooperative
seq3156_all_clean_seqs_gap0_no20_0.4	TCCACATCCTGCTCCTCGGGTTTGCGGCGAGGACTC	25	23	7	5	18	er	cooperative
seq3157_all_clean_seqs_gap0_no20_0.4	ACACTGAGCTGAACGGAAATGTGGTTCTCACCTCAT	22	20	15	14	7	er	cooperative
seq3159_all_clean_seqs_gap1_no20_0.4	AAGGCGGAGGAAGGGAAAATTGTGGTTGGGCAGAGG	23	21	9	8	14	er	independent
seq3164_all_clean_seqs_gap1_no20_0.4	AAAGAGGAAATCACATACCCGAAAACCACATGCACA	26	24	6	5	20	er	independent
seq3165_all_clean_seqs_gap1_no20_0.4	GACCAATGTAAACAAGGATGTGGGTTCTCCGGCCAC	21	19	16	15	5	er	cooperative
seq3166_all_clean_seqs_gap1_no20_0.4	TACAGGAACTTCCTGCGCGGCTGCTGTGGTTGCGAG	27	25	11	9	16	er	cooperative
seq3167_all_clean_seqs_gap1_no20_0.4	GCGCGGCCAGAGAAAGGATGTGGTATAGCAGAAAGT	21	19	16	15	5	er	cooperative
seq3169_all_clean_seqs_gap1_no20_0.4	AGTGGCTACCACTTCCTTCTCTTACCACAGTTCCTT	25	23	14	12	11	er	cooperative
seq3170_all_clean_seqs_gap1_no20_0.4	TGCTTAGCGGGAAGTGCTTACACCACAAAACAAGAC	23	21	10	9	13	er	cooperative
seq3171_all_clean_seqs_gap1_no20_0.4	CCGCCGCGACACTTCCGGCGGCCACCACAGGGTATT	25	23	14	12	11	er	cooperative
seq3174_all_clean_seqs_gap1_no20_0.4	ACACCTCAGGAAGTGGCAGAGACCACAACAAGTCAG	23	21	9	8	14	er	cooperative
seq3175_all_clean_seqs_gap1_no20_0.4	TGGACGTAACACTCAGGAAGTGGTCAACCTTGCTGC	21	19	16	15	5	er	cooperative
seq3177_all_clean_seqs_gap1_no20_0.4	TGGGTGCCGGATTCGGTGAGTGTGGTTCTCATGATG	23	21	9	8	14	er	cooperative
seq3178_all_clean_seqs_gap1_no20_0.4	GGGTTGGGTGCCGGATGCGGTGAGTGAGGTTCTCAT	18	16	13	12	5	er	cooperative
seq3179_all_clean_seqs_gap1_no20_0.4	TCTTGAGGGTCAGGATGTGGTGAGGCCAGAGAAGGC	18	16	13	12	5	er	cooperative
seq3180_all_clean_seqs_gap1_no20_0.4	GTGAGTCACTTCCTGACCATGTGGGTTTTTGGTACG	22	20	11	9	11	er	cooperative
seq3184_all_clean_seqs_gap1_no20_0.4	AATGGGCTTGGTTTCCTGTGGGTTTGTAGCTTTGTA	19	17	14	12	5	er	cooperative
seq3185_all_clean_seqs_gap1_no20_0.4	ACTTACTTCCCGACGTCACAGCCACCGAAACCACAG	31	29	8	6	23	er	independent
seq3186_all_clean_seqs_gap1_no20_0.4	CCTTTACGTTTTCCTGTTGCGGGTTCTATCGCTCTG	20	18	12	10	8	er	cooperative
seq3187_all_clean_seqs_gap1_no20_0.4	AGGGCATTTCCTTTGGGGCTGGTGGTCACGGACAAC	23	21	9	7	14	er	cooperative
seq3189_all_clean_seqs_gap1_no20_0.4	AGTAGGATGGGAGGAAGTGGTTTGTAAGAGGAGGAC	18	16	13	12	5	er	cooperative
seq3190_all_clean_seqs_gap1_no20_0.4	GACTGCACTTCCTCTGCTTCGAGGTCGGTGGTTAGC	29	27	10	8	19	er	cooperative
seq3192_all_clean_seqs_gap1_no20_0.4	GCAGCTCTGGCAGGATGCGGTTAAATATGTAGCCAC	18	16	13	12	5	er	cooperative
seq3193_all_clean_seqs_gap1_no20_0.4	GCTTCTGAGGAAGTGCGTTTTGTGGGTAGGTGGAGT	23	21	9	8	14	er	cooperative
seq3194_all_clean_seqs_gap1_no20_0.4	TAGCCACTAACCGGAAACGTTAAACCACAGCTCCGT	25	23	13	12	12	er	cooperative
seq3196_all_clean_seqs_gap1_no20_0.4	GCCCAGTTCTCGCATCCGGTCTGCGGCGCGCTCGGG	24	22	15	13	9	er	cooperative
seq31_all_clean_seqs_gap0_no20_0.4	TGCCTTCTACTCCGGAACTCAGACCGCTGCCTTCTA	24	22	14	13	10	er	independent
seq323_all_clean_seqs_gap0_no20_0.4	TTCAGGTGACTTCCGGCCGGACCGCTGAGGACGCGG	22	20	12	10	10	er	cooperative
seq85_all_clean_seqs_gap0_no20_0.4	TTCAGGTGACTTCCGGCCGGACCGCTGAGGACGCGG	22	20	12	10	10	er	cooperative
seq328_all_clean_seqs_gap0_no20_0.4	AGATCAACTTCCACATCCGGTGGTAACAGGGCCCTA	21	19	16	14	5	er	cooperative
seq32_all_clean_seqs_gap0_no20_0.4	GAGTGCCGTTTCCCCCGCTCACCGCGGGCTAGGGAG	22	20	11	9	11	er	independent
seq635_all_clean_seqs_gap0_no20_0.4	GGACAAAACATCATAGGAAGTGGGTTTTGGGGTGAG	21	19	16	15	5	er	cooperative
seq336_all_clean_seqs_gap0_no20_0.4	CTTCAAAGTCAGGAAACCGTTAAACCACACTGCATC	25	23	12	11	13	er	ambiguous
seq696_all_clean_seqs_gap0_no20_0.4	CTTCAAAGTCAGGAAACCGTTAAACCACACTGCATC	25	23	12	11	13	er	cooperative
seq338_all_clean_seqs_gap0_no20_0.4	CGGGGTTTCCTGGTGGCTGCGAGCGGTGGGGACGGC	24	22	8	6	16	er	cooperative
seq342_all_clean_seqs_gap0_no20_0.4	ACGTTTCGGGGTTTCCGGGCCAGCGGTTTCGGGCGC	24	22	14	12	10	er	cooperative
seq348_all_clean_seqs_gap0_no20_0.4	TAGGCAGGCAGGATGTGCCTATAAGCCACATGAATG	26	24	11	10	15	er	cooperative
seq350_all_clean_seqs_gap0_no20_0.4	CAGAAACATCCCTCCTGCCGCCGCTTTGTGGTACCA	29	27	9	7	20	er	independent
seq351_all_clean_seqs_gap0_no20_0.4	CTGTCCGCGACATCCGGGACCTGCGGGACCGCCGAT	24	22	13	11	11	er	cooperative
seq353_all_clean_seqs_gap0_no20_0.4	CCCGCTGTCACTTCCTGCTTCCCTCCCGCACACGTG	26	24	13	11	13	er	cooperative
seq354_all_clean_seqs_gap0_no20_0.4	GCGCCCGGAAGGAAGGCTGGGGTAGGTTGTGGTTTC	30	28	7	6	23	er	independent
seq357_all_clean_seqs_gap0_no20_0.4	CAACCCAAGGGGATGTGCTCACTGCGGTGAGGAGGC	25	23	11	10	14	er	ambiguous
seq358_all_clean_seqs_gap0_no20_0.4	AACAAACCGGATGGGGTTCCCACCCGCAATCTTGTC	24	22	9	8	15	er	cooperative
seq360_all_clean_seqs_gap0_no20_0.4	AACCTCCGACTTCCGGCCGCGCAGCGGTGGGCTGAG	25	23	12	10	13	er	cooperative
seq366_all_clean_seqs_gap0_no20_0.4	CACTCCCCGCATCCGGTCTGCGGCGCGCTCGGGGCC	21	19	12	10	9	er	cooperative
seq367_all_clean_seqs_gap0_no20_0.4	CCCACAGGAAATCCCCTGGTCTGTGGCGCCTCTGAT	24	22	7	6	17	er	cooperative
seq36_all_clean_seqs_gap0_no20_0.4	GCCTCCTCAGGAAATTGCCCAAAATAGCCACATGTC	28	26	10	9	18	er	independent
seq372_all_clean_seqs_gap0_no20_0.4	CCCTGGACGGGAAGCGGCGGCCAGATCCGCAAGCCC	27	25	10	9	17	er	cooperative
seq375_all_clean_seqs_gap0_no20_0.4	CCAGCCCAGGAAACAAGGAACCCCAAAGCCACAGGA	29	27	9	8	20	er	cooperative
seq376_all_clean_seqs_gap0_no20_0.4	AGGGTGTGGAGGAAGTGGCTTACAACCACTTTGTCT	26	24	11	10	15	er	cooperative
seq377_all_clean_seqs_gap0_no20_0.4	CCATCCAGGAAGCTTATGGTGCAACCGCAGTGTGCC	25	23	8	7	17	er	cooperative
seq37_all_clean_seqs_gap0_no20_0.4	TGCTTCCCGTCCGTGTCGCGGCCCTGCGGTTGGCGG	27	25	5	3	22	er	cooperative
seq381_all_clean_seqs_gap0_no20_0.4	AGAGTCTTTTTTCCTGAGCGTTTGCGGTTTTGACTT	25	23	12	10	13	er	independent
seq382_all_clean_seqs_gap0_no20_0.4	AGCAGGGCTCGCCGGGAAATGTGGTTTCTCCAGCCG	22	20	15	14	7	er	ambiguous
seq384_all_clean_seqs_gap0_no20_0.4	GGGGAACGGAAGCTGCTGTCGTTACTGGCGGTTGTA	29	27	8	7	21	er	cooperative
seq385_all_clean_seqs_gap0_no20_0.4	AGCTCTAAGGTTCCGCCTGCGGGCAGCAAGCGGAGG	20	18	12	10	8	er	independent
seq387_all_clean_seqs_gap0_no20_0.4	CATTTACAGAAAAGGAAACCGCAAGTTTGAGCAAGT	19	17	14	13	5	er	independent
seq388_all_clean_seqs_gap0_no20_0.4	GGAGCAAGGATGACAGGATGTGGCTTAGGGGGAGGC	21	19	16	15	5	er	cooperative
seq391_all_clean_seqs_gap0_no20_0.4	GATACAGTGCTCAGGAAACCACATGAAACCAGAGTA	19	17	14	13	5	er	ambiguous
seq393_all_clean_seqs_gap0_no20_0.4	AGTTTTCCGTCGGGCTCCCAGTGACGCCGCAGAGGT	27	25	6	4	21	er	cooperative
seq394_all_clean_seqs_gap0_no20_0.4	AGAGCCACATCCCGCGCAGAGGACCGCGGCGACCGG	24	22	10	8	14	er	ambiguous
seq395_all_clean_seqs_gap0_no20_0.4	GGAGGGGAGCAGGAAGCTGAGGTTTTGTGAGTCAGA	20	18	12	11	8	er	cooperative
seq396_all_clean_seqs_gap0_no20_0.4	GAAAGACAGGATGTGGGATAGATCTCAACCACCTTT	29	27	9	8	20	er	cooperative
seq397_all_clean_seqs_gap0_no20_0.4	GAAAGCTGCACTATTTCCTGAGGTTAGAGGTTTAAA	21	19	16	14	5	er	cooperative
seq398_all_clean_seqs_gap0_no20_0.4	ATGGGGAACGGGAAATACGGCGGGAACCACAATCGC	27	25	11	10	16	er	cooperative
seq39_all_clean_seqs_gap0_no20_0.4	AAATCCACTCAGAGGAAACCACAGGCCTGGCCCAGC	19	17	14	13	5	er	ambiguous
seq400_all_clean_seqs_gap0_no20_0.4	GCTAAGGTGAAAGGAAGTGGGTTTTGTCTTTTTTTT	18	16	13	12	5	er	cooperative
seq401_all_clean_seqs_gap0_no20_0.4	GCACTGTAGGCAGGATGTGGGCAGGGGAAACTCAGG	18	16	13	12	5	er	cooperative
seq403_all_clean_seqs_gap0_no20_0.4	AGGTTGAAAGCACTTCCGCTGCGGCCCCCGTAGGAA	22	20	15	13	7	er	cooperative
seq405_all_clean_seqs_gap0_no20_0.4	CCTCCCGACCGGAAGCCCCGCCACAGAGCGGGTTGT	21	19	11	10	10	er	cooperative
seq406_all_clean_seqs_gap0_no20_0.4	AACAACAGGATGCTCTCTAGTCTAACAGTGGTAACA	29	27	8	7	21	er	independent
seq412_all_clean_seqs_gap0_no20_0.4	GTGCCTTTTCATGTGGGATGTGGCTTCAAGGAGACC	21	19	16	15	5	er	independent
seq413_all_clean_seqs_gap0_no20_0.4	GCGATCGGAGCGGAAGTGGAGCTACCGCCACCGCCG	25	23	12	11	13	er	cooperative
seq416_all_clean_seqs_gap0_no20_0.4	GGGAACTGGGGAAGGGGATGTGGTAACCAGAACCAC	21	19	16	15	5	er	cooperative
seq417_all_clean_seqs_gap0_no20_0.4	CACCTAAAGCCATTGGGATGTGGTTTCTCTTTTTCA	21	19	16	15	5	er	independent
seq419_all_clean_seqs_gap0_no20_0.4	CCCACTTCCTGTCCCTGCATGCTGTGGGGCAGGCAG	25	23	7	5	18	er	cooperative
seq423_all_clean_seqs_gap0_no20_0.4	ACAAAACAAACACATCCCCCAAACCGCCAAACTACA	24	22	15	13	9	er	ambiguous
seq428_all_clean_seqs_gap0_no20_0.4	ACTTGACTTCCTGTGGGGTGTGTGGTGTCTGCACTT	23	21	9	7	14	er	cooperative
seq437_all_clean_seqs_gap0_no20_0.4	AACAAAGAGAGAGGAAGTGGGTTGGGCGGGGGGGGT	18	16	13	12	5	er	ambiguous
seq438_all_clean_seqs_gap0_no20_0.4	ATCAGAGCGGAAATCTCAGTCTTGTGTGGGGACCTG	27	25	9	8	18	er	cooperative
seq439_all_clean_seqs_gap0_no20_0.4	CGGCAGGGAAGCAGGAAACCGCGAGTGGAGAAAGGG	19	17	14	13	5	er	cooperative
seq440_all_clean_seqs_gap0_no20_0.4	CCTCACAGGGACTTCCTTCCCCGCGGTTCAGGAATC	24	22	14	12	10	er	independent
seq447_all_clean_seqs_gap0_no20_0.4	CGAAGCCGGAAATGCTGAGTGTGCGGGGCCGAACGT	24	22	8	7	16	er	cooperative
seq448_all_clean_seqs_gap0_no20_0.4	TAAGTGCAGGAAACGGCTGTGTGGGTGTCAGTGATT	22	20	9	8	13	er	cooperative
seq44_all_clean_seqs_gap0_no20_0.4	ATTTTTCCTTCCTTCTCCCGTCCCCGCAGAGTGCAA	24	22	10	8	14	er	independent
seq451_all_clean_seqs_gap0_no20_0.4	GCACGCCATCGAGGAAGTGGGTTTACTGTGTATTTC	18	16	13	12	5	er	cooperative
seq453_all_clean_seqs_gap0_no20_0.4	GACGGCCCCAGCGGAAGTGGTTGCCTTGGTTTGCGC	18	16	13	12	5	er	cooperative
seq456_all_clean_seqs_gap0_no20_0.4	ACCTCAGGTACCGGAAGACCACAATTCCCAGGAGTC	19	17	13	12	6	er	cooperative
seq458_all_clean_seqs_gap0_no20_0.4	TTATGCCTCAGGATGAACGAACCTCAAACACCCAGG	22	20	11	10	11	er	independent
seq460_all_clean_seqs_gap0_no20_0.4	CCTCCGGAACGGCGCGGGGGATTGTGGGGTGTAGGG	25	23	6	5	19	er	independent
seq464_all_clean_seqs_gap0_no20_0.4	AGCTTTCCTTTTCCGGTTGCGGCGCCGCGCGTTGAT	20	18	12	10	8	er	cooperative
seq469_all_clean_seqs_gap0_no20_0.4	GAAGTCACTCAGGGAGGAAACCACAGGGCCGGTCCG	21	19	16	15	5	er	ambiguous
seq46_all_clean_seqs_gap0_no20_0.4	TTGTCAGATGGCGAAGGAAACCGCGAAATTCGCCAT	21	19	16	15	5	er	independent
seq472_all_clean_seqs_gap0_no20_0.4	AGGCCGCTTCCTCCCACATGAAACCGCAGGCTTCGG	24	22	9	7	15	er	independent
seq473_all_clean_seqs_gap0_no20_0.4	CCACGTCCACAAAGGAAACCGCGGCCTGCCCGGGGA	19	17	14	13	5	er	cooperative
seq474_all_clean_seqs_gap0_no20_0.4	CTCTGCCCGCTTCCGCTGGCGGTACCTCAGAGCCGC	20	18	12	10	8	er	cooperative
seq477_all_clean_seqs_gap0_no20_0.4	AGGAGCCGGAAGTCCCGCCCACGCACCCCCCGCAGG	30	28	8	7	22	er	cooperative
seq479_all_clean_seqs_gap0_no20_0.4	GTTCCTAGGCAGGCAGGATGTGGCTATAAGCTACAT	21	19	16	15	5	er	cooperative
seq480_all_clean_seqs_gap0_no20_0.4	TATTGTGTACTTCCCCTTCATGTTGTGGTTGGCTTT	26	24	12	10	14	er	ambiguous
seq482_all_clean_seqs_gap0_no20_0.4	GGTGCCTGGGGAGGATGTGGGCTGACTGGGAGGGGT	18	16	13	12	5	er	cooperative
seq485_all_clean_seqs_gap0_no20_0.4	CCAGGCGGAAGCGGCCGGGAGTAGCGCTGCGGTTGG	30	28	7	6	23	er	cooperative
seq488_all_clean_seqs_gap0_no20_0.4	CTGAGACCTCGGGCAGGATGTGGCTTCCCCAGAGTT	21	19	16	15	5	er	cooperative
seq490_all_clean_seqs_gap0_no20_0.4	GACACCCCACACCGGAAACCTCAGACAGTCCTCAGC	19	17	14	13	5	er	cooperative
seq492_all_clean_seqs_gap0_no20_0.4	GAAACGTCACCCAGAGGAAACCCACAAGGGGCGTGG	22	20	16	15	6	er	ambiguous
seq493_all_clean_seqs_gap0_no20_0.4	CCGGGACCGGAAGAGGGAGCCGTGGTTGCTGGAACT	23	21	9	8	14	er	cooperative
seq498_all_clean_seqs_gap0_no20_0.4	GTGCTGAGCAGCTTCCCGTCTGCGGTGAAGACAGCC	23	21	14	12	9	er	cooperative
seq49_all_clean_seqs_gap0_no20_0.4	GTCACCATTTCCGGGCCTCCGCGGTGTCCCCACCCC	22	20	10	8	12	er	cooperative
seq500_all_clean_seqs_gap0_no20_0.4	CTGGTTTCATTTCCGGGTGCGGCTTCTGTCATAAAG	20	18	12	10	8	er	cooperative
seq501_all_clean_seqs_gap0_no20_0.4	CCAGTGCAGAAACATCCCTCCTGCCGCAGCTTTGTC	24	22	15	13	9	er	independent
seq507_all_clean_seqs_gap0_no20_0.4	TCAGCTGACACAGGAAGTGGTAAAGCTATTATCTGT	18	16	13	12	5	er	cooperative
seq509_all_clean_seqs_gap0_no20_0.4	TGTGTAAGAGGAAACACCAAAACCACAAATATGAAA	23	21	10	9	13	er	independent
seq50_all_clean_seqs_gap0_no20_0.4	TCCACAGCCGGTTCCGGCCGGTTCCCACAAGCCCCT	25	23	13	11	12	er	ambiguous
seq511_all_clean_seqs_gap0_no20_0.4	CAGGGTGTCGGCTTCCGGCGGTTGCCCACTTTCGGC	19	17	14	12	5	er	cooperative
seq513_all_clean_seqs_gap0_no20_0.4	CCACTGCCGGAAGGGGAACTGTGGGGGTGCGCGAGT	22	20	9	8	13	er	ambiguous
seq515_all_clean_seqs_gap0_no20_0.4	CCGCGAGCCGTCACTTCCTGTGGGCTGGGCCGAGCC	21	19	16	14	5	er	cooperative
seq516_all_clean_seqs_gap0_no20_0.4	GGGAGGTGTCCAGGAAGTGGTTGGAGAGTCTGGTCT	18	16	13	12	5	er	ambiguous
seq517_all_clean_seqs_gap0_no20_0.4	AGTCAAACAGGATGTGGCTGGGGAGGCGGTTGTCAC	27	25	10	9	17	er	cooperative
seq518_all_clean_seqs_gap0_no20_0.4	GCAGAGAGGAGGGGATGTGGTTTCACAGCTTGCTCC	18	16	13	12	5	er	independent
seq519_all_clean_seqs_gap0_no20_0.4	GGCGAGGCTGAGAGGAAACCACACTCTCACTGGGGT	19	17	14	13	5	er	independent
seq51_all_clean_seqs_gap0_no20_0.4	GAAGCCAGGAAATGGTGCGTGTGCGGGGCCGGGCGC	24	22	8	7	16	er	cooperative
seq520_all_clean_seqs_gap0_no20_0.4	ATATATCACCCCTTCCTTGCAAAACCACAAGACCAA	25	23	14	12	11	er	independent
seq523_all_clean_seqs_gap0_no20_0.4	TGCAGTCGTGAAAAAGGAAGTGGTTAAAGTGGCTAC	21	19	16	15	5	er	cooperative
seq525_all_clean_seqs_gap0_no20_0.4	CCCAGGCTTCCGGGTTGAATATGTGGGCTGAGGCGA	24	22	9	7	15	er	cooperative
seq526_all_clean_seqs_gap0_no20_0.4	TCCCCACACTTCCGGCCCCGCCCGCACAGCCGCACC	22	20	11	9	11	er	cooperative
seq527_all_clean_seqs_gap0_no20_0.4	GCAATGCCGCTACCGGAAGTGCGGGTCGCGCTCCCG	22	20	15	14	7	er	cooperative
seq528_all_clean_seqs_gap0_no20_0.4	GGACGCCGCCGGAAGCGCGACCCGCACTCCCGGTAG	22	20	11	10	11	er	cooperative
seq530_all_clean_seqs_gap0_no20_0.4	GAAGGAAGTGGAGACAGTAAGGGGAAACCACAAACC	28	26	4	3	24	er	cooperative
seq532_all_clean_seqs_gap0_no20_0.4	TGCTCAGAAGGGCATCCGGTTGCGGAGAAGGTACAC	23	21	15	13	8	er	cooperative
seq533_all_clean_seqs_gap0_no20_0.4	CTTAAATGGGAAATGTAGGTGTGGTTAAGTCACAAA	22	20	9	8	13	er	independent
seq536_all_clean_seqs_gap0_no20_0.4	CGCCCACCACTTCCTGCTGGCGGTCGGCAAGCGTTG	21	19	12	10	9	er	cooperative
seq537_all_clean_seqs_gap0_no20_0.4	TGCAAGAGGAAGCTGGGGTTTGTGGTTCATGTTTTG	23	21	8	7	15	er	independent
seq539_all_clean_seqs_gap0_no20_0.4	TTACCCCAGGAAAAGCCTCCTCACCGCAGTGACCAG	24	22	9	8	15	er	independent
seq53_all_clean_seqs_gap0_no20_0.4	AGTTTCCTGAACTCAGAGCACAGTTGTGGTGCAGAA	27	25	5	3	22	er	cooperative
seq542_all_clean_seqs_gap0_no20_0.4	ACTGAACAAACCGGATGTGGTTCCCACCTGCAATCT	18	16	13	12	5	er	cooperative
seq544_all_clean_seqs_gap0_no20_0.4	GACAGAGGAAACTAGGTGTGACAACCACAAACAGCT	25	23	7	6	18	er	independent
seq545_all_clean_seqs_gap0_no20_0.4	CTGCTAGCGGAAGCAGCCAAGCCCACAGGCTCCAGG	23	21	9	8	14	er	cooperative
seq547_all_clean_seqs_gap0_no20_0.4	CCCGTTCTCCGGAAGTGCGCGGGTTGGAGCTGAAGC	20	18	11	10	9	er	cooperative
seq548_all_clean_seqs_gap0_no20_0.4	CCCCTTCCCGTTCTCCGAAAGTGCGCGGGTTGGAGC	26	24	6	4	20	er	cooperative
seq549_all_clean_seqs_gap0_no20_0.4	CCGGGAAACACGGGAGAGCGACCGAAACCGCAATCA	28	26	4	3	24	er	independent
seq550_all_clean_seqs_gap0_no20_0.4	CTCGTGGGTGCCGGAAGTGGAGGCGGTTGGTGGGGT	24	22	13	12	11	er	cooperative
seq554_all_clean_seqs_gap0_no20_0.4	AATCATCAGGGAAATGCAAATCAAAACCACAATCAG	27	25	10	9	17	er	independent
seq559_all_clean_seqs_gap0_no20_0.4	TCAAGAAAACAGGAAACTCTCAAAACCAAGTTCTGA	26	24	12	11	14	er	cooperative
seq560_all_clean_seqs_gap0_no20_0.4	GGCCCAGGAAAGAGGCAGGGGTGCGGTTTCCCTCCG	24	22	7	6	17	er	independent
seq561_all_clean_seqs_gap0_no20_0.4	CCTGACTTCCTCCTCCCCCTCCCGCCACAATTCCGC	25	23	8	6	17	er	cooperative
seq567_all_clean_seqs_gap0_no20_0.4	TCGGAGACGGCGAAAGGAAACCGCAAGGAGGCCACC	21	19	16	15	5	er	cooperative
seq568_all_clean_seqs_gap0_no20_0.4	TGGAAGGCCGGAAAAGGTTTACCACCACACTCCGGT	22	20	10	9	12	er	cooperative
seq571_all_clean_seqs_gap0_no20_0.4	CTGGGCTCGCCAGGCGGAAGTGGTTGGAGACTGCGT	21	19	16	15	5	er	cooperative
seq581_all_clean_seqs_gap0_no20_0.4	AAATCACATACCCGGAAACCACATGCACAGAAGTGG	19	17	14	13	5	er	cooperative
seq582_all_clean_seqs_gap0_no20_0.4	AGGTTTTGAAAGAGGAAACCACATACCCGAAAACCA	19	17	14	13	5	er	ambiguous
seq583_all_clean_seqs_gap0_no20_0.4	CTTCTTTCCAGAGGATGTGGCTTCAGCGGGAGAGCT	18	16	13	12	5	er	cooperative
seq587_all_clean_seqs_gap0_no20_0.4	GCCGGTGAGGGCGGAAGTGGTAAGACTGACGTGTCC	18	16	13	12	5	er	cooperative
seq589_all_clean_seqs_gap0_no20_0.4	TTCTTCCCCCTTCCGGTCGCTGAGTGGTTGAGGCCG	25	23	12	10	13	er	cooperative
seq590_all_clean_seqs_gap0_no20_0.4	AGCGTTGTCTTCCGGCCTCAACCACTCAGCGACCGG	22	20	11	9	11	er	cooperative
seq592_all_clean_seqs_gap0_no20_0.4	CTCTTCCGCTCAGTCATCCTCAGAGGTGGTAAGACT	27	25	5	3	22	er	independent
seq596_all_clean_seqs_gap0_no20_0.4	GGCGGTGCACTCTGGGAAATGTGGTTTTCGCGGCGC	22	20	15	14	7	er	independent
seq598_all_clean_seqs_gap0_no20_0.4	GATGGGCGAGTCAGGAAACCACAGCTCTGAGGGTGG	19	17	14	13	5	er	independent
seq599_all_clean_seqs_gap0_no20_0.4	GAAGCAGACAGGAAGTGGGTCTGAGCGGTGGAGGGA	26	24	11	10	15	er	cooperative
seq600_all_clean_seqs_gap0_no20_0.4	CCCACTTCCTGTCTGCTTCCCTCCACCGCTCAGACC	26	24	7	5	19	er	cooperative
seq605_all_clean_seqs_gap0_no20_0.4	GCAAGGCAACAGGAAATTGTGGGGAAATTTTAAAAA	20	18	12	11	8	er	cooperative
seq608_all_clean_seqs_gap0_no20_0.4	GGGCTCGGGGAGGAAGCGGTGGTTTCTCTTTGAAGC	20	18	12	11	8	er	cooperative
seq611_all_clean_seqs_gap0_no20_0.4	AGAGGCAGCTTCCGGAGACTGCTCTGTGGCCAGTTT	27	25	11	9	16	er	cooperative
seq613_all_clean_seqs_gap0_no20_0.4	TTTCTTCTGATCTTCCTCCCCGCACGTCTGCACAGG	20	18	14	12	6	er	independent
seq617_all_clean_seqs_gap0_no20_0.4	GTGAATGAGGGGGAAGGAAGTGGTTTGGAAAAATAC	21	19	16	15	5	er	ambiguous
seq619_all_clean_seqs_gap0_no20_0.4	ACCGGATGCCGGGGCACCGCCAGATGTGGCCACGAG	27	25	4	3	23	er	cooperative
seq620_all_clean_seqs_gap0_no20_0.4	AGCGCGCCGCCGACCGGATGCGGGAACTGGGCTCGG	21	19	16	15	5	er	cooperative
seq624_all_clean_seqs_gap0_no20_0.4	TGTCGGGCGGATGTGTACCGGCGGTAATATAGTAAG	22	20	9	8	13	er	cooperative
seq626_all_clean_seqs_gap0_no20_0.4	TTCAGAAAAAAAGGAAGTGGTAAATTCTTGCTGATT	18	16	13	12	5	er	cooperative
seq631_all_clean_seqs_gap0_no20_0.4	GAAGGCGGTTCCGGTTCGCGGCGGTTCCCGGGTTTT	22	20	10	8	12	er	cooperative
seq632_all_clean_seqs_gap0_no20_0.4	GAGGCGACCCACATCCGCTGTGCGGGGGCAACTGCA	23	21	14	12	9	er	cooperative
seq637_all_clean_seqs_gap0_no20_0.4	CTGAGCCGGGACCGGAAGCCGCACCGCCCCCCGCGC	19	17	14	13	5	er	cooperative
seq638_all_clean_seqs_gap0_no20_0.4	GCGGGGACCCGGATGTGTGTGGTGGCGGCGGCCGAA	20	18	11	10	9	er	cooperative
seq63_all_clean_seqs_gap0_no20_0.4	CCTTCCTTCCGGGGTCGGCCCCGCCCGCAAGCGCCG	25	23	8	6	17	er	cooperative
seq650_all_clean_seqs_gap0_no20_0.4	GGGCGCGACTTCCGGGGCGGCGGTTGCATCAGATTC	21	19	11	9	10	er	cooperative
seq652_all_clean_seqs_gap0_no20_0.4	TGGTTAGGGAGAGGGGGATGTGGTTAGGGTGAGGGA	21	19	16	15	5	er	ambiguous
seq653_all_clean_seqs_gap0_no20_0.4	TGAGCTCAGGCCGGAAGCGGTGGATGATGGCACACA	18	16	13	12	5	er	cooperative
seq654_all_clean_seqs_gap0_no20_0.4	GTAGAGACAGGAAATTATGTTGGTTTTCTTGCAGAA	21	19	10	9	11	er	cooperative
seq656_all_clean_seqs_gap0_no20_0.4	GCCCCTTTTTCCTGGGATGAGCGGTTAGCGGAGGGG	22	20	10	8	12	er	independent
seq657_all_clean_seqs_gap0_no20_0.4	CACCTGCAGTGAAGAGGATGTGGGCAAAGATTATGC	21	19	16	15	5	er	cooperative
seq658_all_clean_seqs_gap0_no20_0.4	CCCAACCATTTCCGCCACACCTCCAACCCACTGCCG	28	26	11	9	17	er	cooperative
seq659_all_clean_seqs_gap0_no20_0.4	ATGTTTGGGGCCGGAAGTGGGTTGGAGGTGTGGCGG	18	16	13	12	5	er	cooperative
seq661_all_clean_seqs_gap0_no20_0.4	GGTGTGTTCTGGGGAGGAAGTGGGTTTTCAGGTTGT	21	19	16	15	5	er	cooperative
seq662_all_clean_seqs_gap0_no20_0.4	GTTGGGGTGCGTGTAGGATGTGGTCTGGGATGATTA	21	19	16	15	5	er	independent
seq666_all_clean_seqs_gap0_no20_0.4	GACTCCATTTCCCGTCGGCTCGCGGTGGGAGCGCCG	23	21	10	8	13	er	cooperative
seq667_all_clean_seqs_gap0_no20_0.4	GCCTGCACCCTAGTTCCGGTGTGGGTGGAGGGGCCG	22	20	15	13	7	er	cooperative
seq669_all_clean_seqs_gap0_no20_0.4	CGGGAACACCCACTTCCGCCACAGACCTGCTCAAAA	19	17	15	13	4	er	cooperative
seq66_all_clean_seqs_gap0_no20_0.4	GCATTGTGCTTCCGCTCGGGGAAAGACCGCTTACGG	27	25	11	9	16	er	cooperative
seq671_all_clean_seqs_gap0_no20_0.4	ACACCTCAGGCAGGATGTGGTAGGGGTTGCCCCAGA	18	16	13	12	5	er	cooperative
seq672_all_clean_seqs_gap0_no20_0.4	ACCAGAACTAAAGCGGATAGCGGTTAGAAACGCCCA	21	19	15	14	6	er	independent
seq67_all_clean_seqs_gap0_no20_0.4	GACGGGAGCACCGGAAGCGGTCTTTCCCCGAGCGGA	18	16	13	12	5	er	cooperative
seq682_all_clean_seqs_gap0_no20_0.4	ACCTCAAGCCCAGGATGTGGTTTGGCCACTATTGAG	18	16	13	12	5	er	cooperative
seq683_all_clean_seqs_gap0_no20_0.4	AACTTAGCTTCCGGGAAGAAGGCGAGCGGTGGGAGG	27	25	10	8	17	er	cooperative
seq686_all_clean_seqs_gap0_no20_0.4	TCAGGGGAGCGAGCAGGAAGTGGTAAGATTTGATAG	21	19	16	15	5	er	cooperative
seq688_all_clean_seqs_gap0_no20_0.4	CAGAGAGCGGACTTCCGCGACGCGGGTAAGCCGGGC	23	21	14	12	9	er	cooperative
seq689_all_clean_seqs_gap0_no20_0.4	CCGCTTCCGGCCTTCGCCCGGCTTACCCGCGTCGCA	27	25	6	4	21	er	cooperative
seq690_all_clean_seqs_gap0_no20_0.4	CTGAGCAAAAGGAGGAAGCTGTGGTCTGTGTACCCA	22	20	14	13	8	er	cooperative
seq691_all_clean_seqs_gap0_no20_0.4	TGCATGTGCAGCAGAGGAAACCACAAGTTATTCCCT	21	19	16	15	5	er	independent
seq692_all_clean_seqs_gap0_no20_0.4	TACATCTTCAGAGGAAGTGGGTTTGTGTATCTTTGA	18	16	13	12	5	er	cooperative
seq694_all_clean_seqs_gap0_no20_0.4	CCTGAAGCTCATGCGGAAAACCCACAAAGGGGTGCC	22	20	15	14	7	er	independent
seq697_all_clean_seqs_gap0_no20_0.4	ATGGTGTAGAGAGGATGTGGGCTTTAAGGTCAGAGA	18	16	13	12	5	er	cooperative
seq698_all_clean_seqs_gap0_no20_0.4	TACAGCTGGAACGTCCTGTGGTTAACATTCTGCTCT	19	17	14	12	5	er	independent
seq709_all_clean_seqs_gap0_no20_0.4	ACCTTCTGTTCCCTTCCTCAGACCGCAGGCGAGATG	23	21	15	13	8	er	independent
seq711_all_clean_seqs_gap0_no20_0.4	CAAAGTGATGGGGGAAATGGTTGTGGTTTTGGGTGG	24	22	13	12	11	er	independent
seq713_all_clean_seqs_gap0_no20_0.4	AAACCCCAAACAGGAAGTGGTAAAGCAACCTGCATC	18	16	13	12	5	er	cooperative
seq715_all_clean_seqs_gap0_no20_0.4	GGCCCGGCCGGAAGAAGCCACCTCCCCCGCACGCGT	27	25	10	9	17	er	cooperative
seq717_all_clean_seqs_gap0_no20_0.4	TTAAGGAGCTTCCGGGGCCGCGGGTAGAGGCGGGTG	21	19	11	9	10	er	cooperative
seq718_all_clean_seqs_gap0_no20_0.4	AGGCAAACAGGATGTTCCTCTCCCACATGCAGACTT	23	21	10	9	13	er	cooperative
seq719_all_clean_seqs_gap0_no20_0.4	TACTTCTTCCTGGCAGAGACCGGGAGTGCGGTCCGC	29	27	8	6	21	er	independent
seq720_all_clean_seqs_gap0_no20_0.4	GTGCCGGCGGCCGGATGTGGGCGGGGCCACGGGGAG	18	16	13	12	5	er	cooperative
seq721_all_clean_seqs_gap0_no20_0.4	GTTCTCAGCTTCCTGTTCACAGAGAAACCTCAGACA	28	26	11	9	17	er	cooperative
seq723_all_clean_seqs_gap0_no20_0.4	AGCTAAACCCAGTTCCGGTGCTGTGGGGAGCTCAGA	24	22	14	12	10	er	cooperative
seq724_all_clean_seqs_gap0_no20_0.4	CGGCATCTGACAGGATGTGGGCAGGGAGAGAGAGAC	18	16	13	12	5	er	cooperative
seq726_all_clean_seqs_gap0_no20_0.4	GGATTAGAACTGCTTCCTCCTGTGGTTTACCAGAAA	23	21	15	13	8	er	cooperative
seq731_all_clean_seqs_gap0_no20_0.4	GGGCGGGTCAGCGGAAGTGAGGGCGGTTGAGGCTGG	24	22	13	12	11	er	cooperative
seq736_all_clean_seqs_gap0_no20_0.4	AGGGAGCCCTCCATTTCCTGCCCACATTTGTCACCT	22	20	16	14	6	er	cooperative
seq742_all_clean_seqs_gap0_no20_0.4	AACGACAAACCGGAAGTATGGTTTGCCGCCTGAAGC	19	17	12	11	7	er	cooperative
seq749_all_clean_seqs_gap0_no20_0.4	TCCCCGGCAGCTTCCTCGCCCCGACCGCAGTGTTCC	25	23	13	11	12	er	independent
seq753_all_clean_seqs_gap0_no20_0.4	AGAACAGCAGGAAATAAATACCCACCTCAGGACTGC	22	20	10	9	12	er	ambiguous
seq759_all_clean_seqs_gap0_no20_0.4	GATGCTCTAACAGGAAGTGGGTTAAGGAGCTGCACT	18	16	13	12	5	er	cooperative
seq762_all_clean_seqs_gap0_no20_0.4	ACGAGAGTCTAGAGGAAACCAACCCGCAACTCACTG	24	22	14	13	10	er	independent
seq763_all_clean_seqs_gap0_no20_0.4	TATATGCACAGGAAGTCCCTTACAACCCACTCTGTT	27	25	11	10	16	er	cooperative
seq764_all_clean_seqs_gap0_no20_0.4	GCCAAGGCCTTCCGCCGAGTTGGTTTTTGGGTTGTT	21	19	11	9	10	er	independent
seq770_all_clean_seqs_gap0_no20_0.4	TTAGGCAGAGCTCATTTCCGCCCACATCAAAAGTAA	22	20	17	15	5	er	cooperative
seq771_all_clean_seqs_gap0_no20_0.4	CACCCGCCCCCCGGAAGTGCCGGTGGTTGGGCTCCG	24	22	13	12	11	er	cooperative
seq773_all_clean_seqs_gap0_no20_0.4	AGACCCGGAAATGGTGGGTGTTTCTTGCAACCACGG	31	29	7	6	24	er	cooperative
seq774_all_clean_seqs_gap0_no20_0.4	GAGTCGCTTCCGCTCCCGCCCCGCTCTGTGGCGTAG	29	27	9	7	20	er	cooperative
seq776_all_clean_seqs_gap0_no20_0.4	GAGCGCCCACTTCCTGTTTACCACCCAGCCTCTTCG	21	19	12	10	9	er	cooperative
seq777_all_clean_seqs_gap0_no20_0.4	GACAGGAAGTGACCTCAATTTCCCCGGCCACAGAAA	28	26	5	4	23	er	cooperative
seq778_all_clean_seqs_gap0_no20_0.4	ACCGGGTGCTGAGGAGGAAGTGGTTGCTATAACCCC	21	19	16	15	5	er	cooperative
seq780_all_clean_seqs_gap0_no20_0.4	TTAGGCTCATGGGAAATGTGGTTTCTAAATCGCGGG	19	17	12	11	7	er	independent
seq782_all_clean_seqs_gap0_no20_0.4	AACCCGGAAGTGGACACGGAGCTCGGCTGCGGCTCC	30	28	6	5	24	er	cooperative
seq785_all_clean_seqs_gap0_no20_0.4	CATAGGAAGTGCTCAGCTCTCCTCCACCGCAAGTTT	27	25	5	4	22	er	ambiguous
seq786_all_clean_seqs_gap0_no20_0.4	CTGCCGGAAGCTGCCCCTCCACCATTTTGTGGCCCG	30	28	6	5	24	er	cooperative
seq78_all_clean_seqs_gap0_no20_0.4	CTGCTTCCGGCCCCGGGGTTCGCTACCCCACAATCC	28	26	6	4	22	er	cooperative
seq792_all_clean_seqs_gap0_no20_0.4	ACCCACCCGGAAGTCCTCCTGGCCCACAAGCTCCGC	24	22	9	8	15	er	cooperative
seq793_all_clean_seqs_gap0_no20_0.4	GAGGACTTCCGGGTGCGTGTGATATCTGCGGGCCCG	29	27	8	6	21	er	cooperative
seq794_all_clean_seqs_gap0_no20_0.4	AGCTGCTGTTTTCCGGCTGCGGCACTGGATGAAGGA	20	18	12	10	8	er	cooperative
seq797_all_clean_seqs_gap0_no20_0.4	CCGCCACCGGAAGCGCCCTCCTAATCCCCGCAGCGC	28	26	9	8	19	er	cooperative
seq798_all_clean_seqs_gap0_no20_0.4	GAGATACACAGCGACATCCGCCCGCAAGAGCATGGT	22	20	17	15	5	er	cooperative
seq79_all_clean_seqs_gap0_no20_0.4	GATCTTCCTGCAACCCCCCGAGACAACCACCGAACA	27	25	6	4	21	er	cooperative
seq800_all_clean_seqs_gap0_no20_0.4	GAGCCGGAAGTGAAGGAGGGCTTGTGGGAGATGGAG	25	23	6	5	19	er	cooperative
seq803_all_clean_seqs_gap0_no20_0.4	TGCGCCGCGGAACCCGGAAGTGGTCACGGAGCTCGG	21	19	16	15	5	er	cooperative
seq806_all_clean_seqs_gap0_no20_0.4	GGTCAGGTGGGCGTTTCCTGTGGGCGTCTCCAACTC	21	19	16	14	5	er	cooperative
seq807_all_clean_seqs_gap0_no20_0.4	CCAACAGTACCCTTCCTCCCTTAACCACAAGACTGA	25	23	14	12	11	er	independent
seq808_all_clean_seqs_gap0_no20_0.4	ATGTTAACATCCTGCCATGAAAACCGCAAGAAGGGC	24	22	10	8	14	er	independent
seq809_all_clean_seqs_gap0_no20_0.4	GTCCTCTTCCTGTCCCCCAGGTGGGCATGTGGTTTG	30	28	8	6	22	er	cooperative
seq810_all_clean_seqs_gap0_no20_0.4	TCTTTGAGAAGCGGATGTGGTAAACTTGCCTCTGTT	18	16	13	12	5	er	cooperative
seq814_all_clean_seqs_gap0_no20_0.4	TAAGGATGTGTGGCTTCCAGATCAAAAACCGCAAAA	29	27	4	3	25	er	ambiguous
seq81_all_clean_seqs_gap0_no20_0.4	CTGTCTGCTTCCCGTGGCCAGCCCTGACCGCGGCCC	28	26	10	8	18	er	cooperative
seq822_all_clean_seqs_gap0_no20_0.4	GTGAGAGGAAGTGGGCGCTGGTTTAATGTGGTCAGC	29	27	7	6	22	er	cooperative
seq824_all_clean_seqs_gap0_no20_0.4	GTCCCACGCGACTTCCTGCGGGAAACATGGCGGCAT	19	17	14	12	5	er	cooperative
seq825_all_clean_seqs_gap0_no20_0.4	CGTCACTTCCCACGCGACTGCCTGCGGGAAACATGG	25	23	8	6	17	er	cooperative
seq826_all_clean_seqs_gap0_no20_0.4	TGGGGCCCGGAAGCGCTGGCGCCTTGCGGCCAGAAG	27	25	9	8	18	er	cooperative
seq827_all_clean_seqs_gap0_no20_0.4	ACGTCAGCATCCGCCGGGCTCGCGGTAAGGTGTGAG	23	21	10	8	13	er	cooperative
seq830_all_clean_seqs_gap0_no20_0.4	GCCCGGAAGCGCGACGCTGGAGCTGCGGGGTTACCA	26	24	5	4	21	er	cooperative
seq832_all_clean_seqs_gap0_no20_0.4	CAGTGCCAGCCGGAACTTGTGGTTCGGACCGTGGGT	20	18	12	11	8	er	ambiguous
seq833_all_clean_seqs_gap0_no20_0.4	TCCCCACATCCTTTAAAACGATGAGATAACCACATG	30	28	9	7	21	er	cooperative
seq835_all_clean_seqs_gap0_no20_0.4	CAAGAGGAACCGGAACTTTGGAAACCACATTCTTAT	25	23	12	11	13	er	cooperative
seq837_all_clean_seqs_gap0_no20_0.4	AGAGCGAGGAGGACTTCCTGCGGCAGGTCGGCGTGA	21	19	16	14	5	er	cooperative
seq83_all_clean_seqs_gap0_no20_0.4	GCGCGGGCAACTTCCGGTGTGGGTGACGAGTGGTGG	20	18	13	11	7	er	cooperative
seq843_all_clean_seqs_gap0_no20_0.4	GCTGTCCGTTTCCGAGATGTTAATGCGGGGTCTTGC	26	24	11	9	15	er	cooperative
seq844_all_clean_seqs_gap0_no20_0.4	GCTGTCCGTTTCCGAGATGTTAATGCGGGATCTTGC	26	24	11	9	15	er	independent
seq845_all_clean_seqs_gap0_no20_0.4	CATCTCGGAAACGGACAGCAAGATCCCGCATTAACA	26	24	7	6	19	er	independent
seq847_all_clean_seqs_gap0_no20_0.4	ACAGTCGCACCGGAAGCTGCCCGCGGTGTTGACACA	24	22	12	11	12	er	cooperative
seq850_all_clean_seqs_gap0_no20_0.4	GAAATTTCCGCTTTCTTTCTGCAGCAGGAACCGCGG	31	29	7	5	24	er	cooperative
seq853_all_clean_seqs_gap0_no20_0.4	GCCTCCTCCCATTTCCTCCATGTGGTCAATCCAGTT	23	21	14	12	9	er	cooperative
seq856_all_clean_seqs_gap0_no20_0.4	ACAGGAAGAGATATTATATCTCCCTGCGGTTGGTTT	27	25	4	3	23	er	ambiguous
seq857_all_clean_seqs_gap0_no20_0.4	CGGCTGGCAGGAAGTGGCCACTTGAACCGCAGATGC	27	25	10	9	17	er	cooperative
seq858_all_clean_seqs_gap0_no20_0.4	ACCAGCCCAGGAAGCATCTGCGGTTCAAGTGGCCAC	21	19	10	9	11	er	cooperative
seq861_all_clean_seqs_gap0_no20_0.4	TGCCGGGCCCCGGATGTCACCGCAGCCGCCATCTTA	20	18	12	11	8	er	cooperative
seq864_all_clean_seqs_gap0_no20_0.4	GAAGCGCTGGGCGGAAGTGGCTGTGGCTTTGCCCTT	24	22	13	12	11	er	cooperative
seq873_all_clean_seqs_gap0_no20_0.4	CCCCGGGAAGGGAAGTTTGTGGCGGAGGAGGTTCGT	20	18	11	10	9	er	independent
seq874_all_clean_seqs_gap0_no20_0.4	CCTGCCTGACCGGAAGTGCCCGCAACCCCACCGACC	20	18	12	11	8	er	cooperative
seq879_all_clean_seqs_gap0_no20_0.4	TGTGATAAGGATGTTCGTGTGCCTTGTGGTCAGGTG	27	25	9	8	18	er	independent
seq880_all_clean_seqs_gap0_no20_0.4	AGAAACATCCTGCCCAGCCACCTGACCACAAGGCAC	26	24	8	6	18	er	cooperative
seq882_all_clean_seqs_gap0_no20_0.4	TGTTTTCGCTCTTCCTGGCCTTGCGGGCAGCCAGGA	24	22	13	11	11	er	independent
seq884_all_clean_seqs_gap0_no20_0.4	CCGCGCCGCTTCCTCCAGACACCGCAAGGGGGTGCT	22	20	11	9	11	er	cooperative
seq885_all_clean_seqs_gap0_no20_0.4	GGGTGCTTCCTATAAACAATGACTCATTACCGCACT	30	28	8	6	22	er	independent
seq889_all_clean_seqs_gap0_no20_0.4	CCATATCTGGCTTCCTAAGGAGGAACCACAAACCGT	26	24	13	11	13	er	independent
seq892_all_clean_seqs_gap0_no20_0.4	TCTCTACTTCCCATTATTTCTGTGGTTAATTTCACC	23	21	9	7	14	er	independent
seq897_all_clean_seqs_gap0_no20_0.4	GAGAACTTCCGGTGCGCTCCCCGGGACTGCGGTCCC	30	28	8	6	22	er	cooperative
seq898_all_clean_seqs_gap0_no20_0.4	GCAGAGAGGAAGTGTGGGGGTGGAGGAGGCCGCAGA	30	28	8	7	22	er	cooperative
seq899_all_clean_seqs_gap0_no20_0.4	TGGAGTGAAGCGGCTTCCTTGCGGTTGTGTGCGTGT	22	20	16	14	6	er	independent
seq901_all_clean_seqs_gap0_no20_0.4	GCCTGAAGGACTTCCGGGAACCGCAAAGCACGGTGT	21	19	13	11	8	er	cooperative
seq903_all_clean_seqs_gap0_no20_0.4	GCCACACTTCCGGCGGGGCTGCGACCGCAGAGGGGC	25	23	9	7	16	er	cooperative
seq904_all_clean_seqs_gap0_no20_0.4	GGCCCCTGCTTCCGGGTGTGACGCGAACCGCGGGCA	28	26	11	9	17	er	cooperative
seq905_all_clean_seqs_gap0_no20_0.4	CAGCGGCCGTCGCGGGAAGTGCGGTCGCCGCGGCCA	22	20	15	14	7	er	independent
seq906_all_clean_seqs_gap0_no20_0.4	TCCTCCGTTTCCGTAGTTCCGAGTTGCGGTTTCTCC	27	25	10	8	17	er	independent
seq907_all_clean_seqs_gap0_no20_0.4	CAACCCGGAAGCACTAACGGAGAAACCGCAACTCGG	26	24	7	6	19	er	cooperative
seq909_all_clean_seqs_gap0_no20_0.4	GGGCAGCAGCAGACCGGAAACCACAGCCGACTAAGA	21	19	16	15	5	er	cooperative
seq912_all_clean_seqs_gap0_no20_0.4	CCATTCTTCCGGTGGAGATGGCTGCGGCCGTGGCGG	25	23	8	6	17	er	cooperative
seq913_all_clean_seqs_gap0_no20_0.4	ACTCCCTAGAGCAGGAAGCCTGTGGTTTGTAATTGG	23	21	14	13	9	er	cooperative
seq915_all_clean_seqs_gap0_no20_0.4	CTCCACCGGATGCAGCAATGAAGGCCGCAGGAATGG	25	23	8	7	17	er	cooperative
seq916_all_clean_seqs_gap0_no20_0.4	TGCGCCGCTTCCGCTGCCCGAGGAAGAGCCGCAGTC	29	27	10	8	19	er	cooperative
seq918_all_clean_seqs_gap0_no20_0.4	CCGATGGCGGCGGAACTGTGGTCAGGGCTGCCCTGA	19	17	12	11	7	er	independent
seq919_all_clean_seqs_gap0_no20_0.4	GAGCGCAGGACGGAAGCTCGGTGCGGGTGCGGCCTC	24	22	12	11	12	er	cooperative
seq920_all_clean_seqs_gap0_no20_0.4	GGAGGAAGTGACACCCACCCACTGCCCCCGCAAGGT	28	26	4	3	24	er	cooperative
seq923_all_clean_seqs_gap0_no20_0.4	AGCCCGGCTTCCGGCGCGTGCCGCTGCGGCTGCAGG	27	25	10	8	17	er	cooperative
seq924_all_clean_seqs_gap0_no20_0.4	CGGGCCGGATCGCCTTCGCCGCCGCCCGCCCGCAAA	30	28	7	6	23	er	independent
seq926_all_clean_seqs_gap0_no20_0.4	CCTGCCTTCCGTCTTCCAGGCAGAACCACAGAGAGG	26	24	8	6	18	er	independent
seq928_all_clean_seqs_gap0_no20_0.4	GAAGTCACATCCTGTCTGTTGCGGCAGGGCACAGAG	22	20	10	8	12	er	cooperative
seq929_all_clean_seqs_gap0_no20_0.4	TCTAGTAAAAGAGGAAGTTCTTAACCACATTTCCAT	25	23	13	12	12	er	cooperative
seq931_all_clean_seqs_gap0_no20_0.4	TATCACATCCTGCCGGACAAAAAGGCCAAACCACCT	31	29	8	6	23	er	cooperative
seq938_all_clean_seqs_gap0_no20_0.4	GGCATTCACTTCCGGTCTGGGGCCTGCGGCGGCGGC	27	25	11	9	16	er	cooperative
seq93_all_clean_seqs_gap0_no20_0.4	CTGCCGCGACAGACAGGATGTGGCTTCTGCTCTGTC	21	19	16	15	5	er	cooperative
seq940_all_clean_seqs_gap0_no20_0.4	CACTTCCTATCGCTACATAACAAATTACCACAGACT	28	26	5	3	23	er	cooperative
seq942_all_clean_seqs_gap0_no20_0.4	GGGCCAGAGACGCCGGAAGTGACCGCGCGGTGCGCC	23	21	15	14	8	er	cooperative
seq943_all_clean_seqs_gap0_no20_0.4	CTCCTTCCTGATCGGGCAGGAACTAACCACAGGAGG	27	25	6	4	21	er	cooperative
seq944_all_clean_seqs_gap0_no20_0.4	GTGCTAAGTGAGGAAGTGCAGTTTACCGCACGGTGG	26	24	12	11	14	er	cooperative
seq945_all_clean_seqs_gap0_no20_0.4	CGATTCCGGAGACAGGCCCCACCGTGCGGTAAACTG	27	25	5	3	22	er	independent
seq946_all_clean_seqs_gap0_no20_0.4	GACCCGGCCCGCCCCTTCCGGCCGCAGCGCGGGGCA	22	20	17	15	5	er	cooperative
seq953_all_clean_seqs_gap0_no20_0.4	TCGCTTCCGGTGTCGGTTACAGACTGTGGTTGCCAT	27	25	6	4	21	er	cooperative
seq954_all_clean_seqs_gap0_no20_0.4	TGGTGCCAAACATCCGCTAGCCACAGAAAAACCGAC	21	19	13	11	8	er	cooperative
seq955_all_clean_seqs_gap0_no20_0.4	CGAAAGTGACCGGAAGTAACCGCCGGGCCAAGATGG	20	18	12	11	8	er	cooperative
seq956_all_clean_seqs_gap0_no20_0.4	AGGTTCCGGCGAAAGTGACCGAAAGTAACCGCCGGG	29	27	5	3	24	er	cooperative
seq957_all_clean_seqs_gap0_no20_0.4	CGGCGCGGCGGACGTTGCTGCGGTAGGACGTGCCCG	21	19	10	9	11	er	ambiguous
seq959_all_clean_seqs_gap0_no20_0.4	ACAGATCCAAGGAAGCATATCCCGCAAGCAACTGTT	22	20	11	10	11	er	independent
seq962_all_clean_seqs_gap0_no20_0.4	CAATGGATGGCCACATCCTCACCACAAACTGAGTCA	22	20	16	14	6	er	cooperative
seq964_all_clean_seqs_gap0_no20_0.4	AGTGGAGTAGGAACCGGAAAACCACAATAAGTCCCA	22	20	16	15	6	er	cooperative
seq965_all_clean_seqs_gap0_no20_0.4	TGAAGCAGGCGGAAGTGCTGTGGTTTCTGGCGACTG	21	19	11	10	10	er	cooperative
seq967_all_clean_seqs_gap0_no20_0.4	AACAGTTGCATAGGAAGTGGTCAGCTCTCCTCCACC	18	16	13	12	5	er	cooperative
seq971_all_clean_seqs_gap0_no20_0.4	CAGAGCCAAACATGCGGAAGTGGTTACGTGTACTAG	21	19	16	15	5	er	cooperative
seq973_all_clean_seqs_gap0_no20_0.4	GCCAACAGGAAGCTGGAAGCCAACCGCACTGTGTGC	24	22	8	7	16	er	cooperative
seq974_all_clean_seqs_gap0_no20_0.4	GGCTTTCCGTTCAAGGATCTTTTTGCGGTCTTTGTC	26	24	6	4	20	er	cooperative
seq975_all_clean_seqs_gap0_no20_0.4	CCAGCGGAAAGCCGGTCAGGGGGAACCGCGGCGGGG	26	24	6	5	20	er	independent
seq976_all_clean_seqs_gap0_no20_0.4	GCTGATAGAACAGGATGTGGTAAAGAAGCAGGCCAA	18	16	13	12	5	er	cooperative
seq978_all_clean_seqs_gap0_no20_0.4	CCTGTTGATAAAACAGGATGTGGTAAAGAAGCTGGC	21	19	16	15	5	er	cooperative
seq979_all_clean_seqs_gap0_no20_0.4	GCGCCCCGCTTCCGGGGCCGCCCTAAACCGCGGCCG	28	26	11	9	17	er	cooperative
seq981_all_clean_seqs_gap0_no20_0.4	CCCGCTACACAAGGCGGATGTGGTACCCTCACTTGT	21	19	16	15	5	er	cooperative
seq982_all_clean_seqs_gap0_no20_0.4	GTCTTAGGTCGGAAGTCTGTGGTCCCTGTTCACATG	20	18	11	10	9	er	independent
seq985_all_clean_seqs_gap0_no20_0.4	AGTCCACACTACAGGAAACCACAGGCCTGAGCCCCA	19	17	14	13	5	er	ambiguous
seq988_all_clean_seqs_gap0_no20_0.4	TGGCTTATCCTAACAGGAAGTGGTTTATCTGATCCT	21	19	16	15	5	er	cooperative
seq989_all_clean_seqs_gap0_no20_0.4	GCGGAGGCGGAAGTCGTGCTGCTGCTGACCACGGCT	29	27	9	8	20	er	cooperative
seq98_all_clean_seqs_gap0_no20_0.4	GACCGAGAGGAAGCAGCAAGGATCCTGCGGTTCCAG	28	26	9	8	19	er	independent
seq991_all_clean_seqs_gap0_no20_0.4	GTACTGAGTCACAGGAAACCACAAGGGAAGGGTCCC	19	17	14	13	5	er	cooperative
seq997_all_clean_seqs_gap0_no20_0.4	ATCAGTCAACTTCCCCCACTCCCTCCCACAAAGAAA	26	24	12	10	14	er	independent
seq998_all_clean_seqs_gap0_no20_0.4	AGCTCCCCTCCCCGGAAACTTGACCACCTAGCCCAG	24	22	14	13	10	er	ambiguous
